的	白 勹 丶
一	一
是	是
不	不
了	了
在	在字框 土
我	我
人	人
他	亻 也
这	文 辶
有	左字框 青字底
个	全字头 丨
大	大
上	上
中	中
来	来
地	土 也
和	禾 口
说	讠 丷 兄
为	丶 力 丶
们	亻 门
到	至 刂
你	你
就	京 尤
也	也
以	以字旁 人
国	囗 玉
那	那字旁 阝
要	覀 女
时	日 寸
出	屮 凵
着	差字头 目
可	可
道	首 辶
之	之
对	又 寸
会	全字头 云
自	自
而	而
得	彳 旦 寸
下	下
能	厶 青字底 匕 匕
过	寸 辶
生	生
子	子
于	一 于无横
年	卧人 年字底
后	后字框 口
发	发
都	者 阝
里	里
没	氵 殳
还	不 辶
所	戶 斤
去	去
看	龵 目
事	同字心 隶字框
如	女 口
用	用
小	小
作	亻 乍
多	夕 夕
行	行
只	只
好	女 子
成	成三 戈无一
家	宀 豕
天	天
她	女 也
方	方
然	然左角 犬 灬
当	尚字头 彐
心	心
起	走 己
种	禾 中
想	相 心
经	纟 经右角 工
现	王 见
但	亻 旦
法	氵 去
无	无
同	冂 同字心
么	丿 厶
进	井 辶
学	学无子 子
面	面
其	其
前	䒑 青字底 刂
已	已
主	主
从	从
动	云 力
分	分
把	扌 巴
开	开
军	冖 车
又	又
两	两
本	本
因	囗 大
定	定
部	咅 阝
与	与
将	丬 夕 寸
日	日
长	长
理	王 里
三	三
些	此 二
实	宀 冬字底 大
样	木 羊
十	十
意	音 心
知	矢 口
此	此
第	竹头 弓 弟省无弓
力	力
很	彳 艮
正	正
高	高
手	手
什	亻 十
身	身
被	衤 皮
它	宀 匕
明	日 月
老	老
者	者
公	公
见	见
机	木 几
向	向字框 口
问	门 口
最	日 耳 又
使	亻 同字心 乂
全	全字头 王
点	占 灬
情	忄 龶 青字底
外	夕 卜
民	民
并	丷 开
战	占 戈
关	关
工	工
回	囗 口
等	竹头 土 寸
相	相
二	二
重	𡈼 旦
由	由
头	冬字底 大
声	士 眉字框
性	忄 生
应	广 应字心
间	门 日
话	讠 舌
文	文
给	纟 合
美	美字头 大
业	业
物	牜 勹 横两撇
真	直 八
体	亻 本
或	戈 口 一
政	正 攵
几	几
内	内
利	禾 刂
打	扌 丁
走	走
新	亲 斤
位	亻 立
西	西
再	一 冉
产	产
加	力 口
月	月
却	去 卩
先	先
制	牛 冂 刂
特	牜 土 寸
果	果
东	东二 小
神	礻 日 丨
儿	儿
才	才
门	门
太	太
合	合
信	亻 言
表	龶 衣省
原	原
女	女
更	更
己	己
名	夕 口
立	立
比	比
代	亻 弋
四	四
斯	其 斤
任	亻 壬
次	冫 欠
世	廿 乛
便	亻 更
听	口 斤
提	扌 是
做	亻 古 攵
海	氵 卧人 母
水	水
教	耂 子 攵
眼	目 艮
化	化
通	龴 甬字底 辶
感	戊 同字心 心
王	王
各	各
口	口
气	气
别	另 刂
少	少
处	夂 卜
平	平
常	尚头 巾
解	角 刀 牛
何	亻 可
接	扌 妾
目	目
反	反字框 又
变	变字头 又
笑	竹头 夭
总	兑字头 心
入	入
认	讠 人
条	夂 朩
安	宀 女
金	金
及	及
度	度字框 又
让	讠 上
山	山
马	马
受	爱字头 又
活	氵 舌
结	纟 士 口
数	娄 攵
直	直
必	心 丿
白	白
指	扌 匕 日
张	弓 长
报	扌 报字边无又 又
论	讠 仑
员	员
义	丶 乂
放	方 攵
电	电
至	至
五	五
系	丿 糸
难	又 隹
命	亼 口 卩
建	聿 廴
尔	尔字头 小
件	亻 牛
死	歹 匕
保	亻 口 木
完	宀 元
许	讠 卧人 十
题	是 页
场	土 乛 横两撇
空	穴 工
计	讠 十
怎	乍 心
光	光
管	竹头 宀 㠯
非	非
德	彳 十 罒 一 心
强	弓 口 虫
量	旦 里
决	冫 夬
形	开 彡
像	亻 象
期	其 月
资	冫 欠 贝
队	阝 人
清	氵 龶 青字底
务	夂 力
嗯	口 囗 大 心
统	纟 充字头 儿
书	乛 乛 丨 丶
市	亠 巾
司	乛 同字心
师	师字旁 一 巾
住	亻 主
即	即字旁 卩
克	古 儿
带	带字头 冖 巾
飞	飞
南	十 冂 南字心
区	区
李	木 子
则	贝 刂
觉	学无子 见
交	交
社	礻 土
今	今
基	其 土
北	北
展	尸 展字心
传	亻 专
连	车 辶
叫	口 丩
治	氵 厶 口
路	足旁 各
万	万
告	告字头 口
科	禾 斗
呢	口 尸 匕
思	田 心
达	大 辶
记	讠 己
转	车旁 专
望	亡 月 王
边	力 辶
快	忄 夬
风	风
色	尔字头 巴
该	讠 亥
界	田 介
象	象
权	木 又
拉	扌 立
设	讠 殳
且	且
取	耳 又
干	干
收	丩 攵
步	止 步字底
领	今 丶 页
林	林
根	木 艮
往	彳 主
亲	亲
极	木 及
求	求
未	未
每	卧人 母
程	禾 口 王
式	弋 工
兵	兵
据	扌 居
类	米 大
言	言
规	夫 见
吧	口 巴
品	口 吅
确	石 角
观	又 见
城	土 成三 戈无一
虽	口 虫
失	丿 夫
格	木 各
远	元 辶
办	力 横两点
元	元
运	云 辶
令	今 丶
共	共
似	亻 以字旁 人
准	冫 隹
请	讠 龶 青字底
武	一 弋 止
士	士
改	己 攵
英	艹 见二 大
术	木 丶
车	车
石	石
深	氵 㓁 木
联	耳 关
争	尔字头 争字底
吗	口 马
院	阝 宀 元
轻	车旁 经右角 工
火	火
罗	罒 夕
百	百
夫	夫
离	㐫 禸
花	艹 化
近	斤 辶
切	七 刀
识	讠 只
造	告字头 口 辶
组	纟 且
流	氵 㐬
算	竹头 目 廾
布	左字框 巾
导	巳 寸
早	早
找	扌 戈
候	修字旁 候右角 矢
满	氵 艹 两
服	月 报字边无又 又
官	宀 㠯
整	束 攵 正
爱	爱字头 友
字	宀 子
持	扌 土 寸
跟	足旁 艮
突	穴 犬
影	景 彡
消	氵 尚字头 青字底
随	阝 左字框 青字底 辶
吃	口 卧人 乙
商	立无横 𠕉字底 口
证	讠 正
单	丷 旦 丨
议	讠 丶 乂
越	走 戉
存	在字框 子
击	举字底 凵
精	米 龶 青字底
济	氵 齐
始	女 厶 口
台	厶 口
黑	黑
调	讠 周字框 土 口
需	雨头 而
支	支
杀	乂 朩
团	囗 才
功	工 力
具	具字头 八
华	化 十
脸	月 亼 应字心
府	广 亻 寸
集	隹 木
周	周字框 土 口
青	龶 青字底
红	纟 工
双	双
九	九
八	八
片	片
半	半
容	宀 谷
曾	丷 曾字头无丷 日
啊	口 阝 可
阿	阝 可
落	落字框 各
显	日 业
除	阝 全字头 余字底
尽	尺 冬字底
党	尚头 儿
照	日 刀 口 灬
众	全字头 从
备	夂 田
复	卧人 日 夂
陈	阝 东二 小
断	米 乛 斤
价	亻 介
约	纟 勹 丶
写	冖 与
包	包
级	纟 及
另	另
病	疒 一 内
质	反字框 十 贝
称	禾 尔字头 小
倒	亻 至 刂
六	六
江	氵 工
绝	纟 尔字头 巴
敌	舌 攵
黄	黄
技	扌 支
朝	龺 月
派	氵 反字框 旅下角
线	纟 戋
站	立 占
究	穴 九
装	丬 士 衣
亚	亚
首	首
刚	冂 乂 刂
示	示
视	礻 见
况	冫 兄
增	土 丷 曾字头无丷 日
谈	讠 火 火
惊	忄 京
古	古
史	口 乂
谁	讠 隹
引	弓 丨
须	彡 页
七	七
息	自 心
研	石 开
际	阝 示
器	吅 犬 吅
易	日 勹 横两撇
留	留字头 田
推	扌 隹
坐	从 土
房	户 方
广	广
注	氵 主
查	木 旦
语	讠 五 口
念	今 心
若	艹 左字框 口
奇	大 可
紧	贤字头 糸
企	全字头 止
希	乂 左字框 巾
委	禾 女
响	口 向字框 口
号	口 丂
参	厶 大 彡
势	执 力
历	厂 力
剑	亼 应字心 刂
攻	工 攵
冷	冫 今 丶
投	扌 殳
哪	口 那字旁 阝
农	冖 衣省
专	专
图	囗 夂 冬字底
考	耂 丂
选	先 辶
终	纟 夂 冬字底
微	微字框无一 一 几
皇	白 王
土	土
局	尸 乛 口
星	日 生
足	足
刘	文 刂
甚	其 乛
严	亚 丿
医	匚 矢
男	田 力
营	荧字头 吕
乎	乊 于无横
仅	亻 又
父	父
拿	合 手
孩	子 亥
答	竹头 合
费	弗 贝
标	木 示
依	亻 衣
兴	兴
低	亻 氏 丶
千	千
仍	亻 乃
急	刍 心
护	扌 户
竟	音 儿
某	甘 木
较	车旁 交
防	阝 方
列	歹 刂
讲	讠 井
破	石 皮
客	宀 各
施	旅字框 也
故	古 攵
血	血
节	艹 节字底
云	云
龙	龙
钱	钅 戋
苏	艹 力 横两点
母	母
伤	亻 卧人 力
举	兴 举字底
族	旅字框 矢
按	扌 宀 女
维	纟 隹
修	修字旁 夂 彡
帝	立无横 冖 巾
河	氵 可
威	戊 一 女
巴	巴
划	戈 刂
致	至 攵
案	宀 女 木
革	革
底	广 氏 丶
送	关 辶
冲	冫 中
音	音
态	太 心
够	句 夕 夕
段	段字旁 殳
构	木 勹 厶
群	君 羊
船	舟 几 口
责	龶 贝
苦	艹 古
章	立 早
律	彳 聿
愿	原 心
围	囗 韦
京	京
衣	衣
喜	壴 口
独	犭 虫
效	交 攵
斗	斗
细	纟 田
怕	忄 白
志	士 心
米	米
晚	日 免五 儿
热	执 灬
项	工 页
料	米 斗
例	亻 歹 刂
灵	彐 火
密	宀 心 丿 山
害	宀 丰 口
供	亻 共
属	尸 丿 口 禺字底
验	马 亼 应字心
境	土 音 儿
毛	毛
般	舟 殳
居	居
继	纟 米 乛
错	钅 龷 日
沉	氵 冖 几
采	爫 木
既	即字旁 旡
察	宀 祭字头 示
否	不 口
批	扌 比
脑	月 㐫
夜	亠 亻 夜下角
股	月 殳
速	束 辶
纪	纟 己
续	纟 卖字头 冬字底 大
假	亻 叚
帮	寿字头 阝 巾
乐	乐二 小
陆	阝 举字底 凵
型	开 刂 土
退	艮 辶
友	友
铁	钅 丿 夫
汉	氵 又
暗	日 音
状	丬 犬
左	左字框 工
句	句
雷	雨头 田
网	冂 乂 乂
率	亠 幺 率字腰 十
值	亻 直
普	䒑 业 日
承	氶 三
停	亻 亮字头 丁
试	讠 弋 工
弹	弓 丷 旦 丨
止	止
职	耳 只
药	艹 纟 勹 丶
久	久二 丶
印	印字旁 卩
卫	节字底 一
助	且 力
掌	尚头 手
织	纟 只
阳	阝 日
待	彳 土 寸
初	衤 刀
追	追字心 辶
木	木
哈	口 合
您	你 心
预	予 页
刻	亥 刂
创	全字头 㔾 刂
诉	讠 斤 丶
简	竹头 门 日
射	身 寸
限	阝 艮
球	王 求
差	差字头 工
树	木 又 寸
校	木 交
兰	䒑 二
怪	忄 又 土
阵	阝 车
异	巳 廾
宗	宀 示
波	氵 皮
育	充字头 青字底
激	氵 白 方 攵
担	扌 旦
顿	屯 页
游	氵 旅字框 子
充	充字头 儿
银	钅 艮
适	舌 辶
省	少 目
胡	古 月
食	食
警	艹 句 攵 言
素	龶 糸
尼	尸 匕
排	扌 非
负	尔字头 贝
背	北 青字底
忽	勹 横两撇 心
酒	氵 酉
穿	穴 牙
福	礻 同字心 田
弟	丷 弓 弟省无弓
怀	忄 不
欢	又 欠
环	王 不
招	扌 刀 口
模	木 莫
胜	月 生
痛	疒 龴 甬字底
习	习
险	阝 亼 应字心
财	贝 才
益	益字头 皿
宝	宀 玉
脚	月 去 卩
疑	匕 矢 龴 疋
乱	舌 乛
赶	走 干
坚	贤字头 土
获	艹 犭 犬
劳	荧字头 力
挥	扌 冖 车
敢	乛 耳 攵
置	罒 直
右	左字框 口
压	厂 土 丶
香	禾 日
层	尸 云
略	田 各
静	龶 青字底 尔字头 争字底
村	木 寸
范	落字框 㔾
源	氵 原
副	同字心 田 刂
州	横三点 川
纳	纟 内
岁	山 夕
罪	罒 非
余	全字头 余字底
闻	门 耳
占	占
玉	玉
哥	可 可
杨	木 乛 横两撇
忙	忄 亡
兄	兄
守	宀 寸
跑	足旁 包
述	木 丶 辶
座	广 从 土
田	田
摇	扌 爫 缶
超	走 刀 口
演	氵 宀 一 由 八
皮	皮
喝	口 曷
买	乛 冬字底 大
佛	亻 弗
室	宀 至
角	角
卡	上 卜
封	圭 寸
策	竹头 木框 冂
块	土 夬
富	宀 同字心 田
判	丷 夫三 刂
配	酉 己
姑	女 古
优	亻 尤
征	彳 正
善	羊 䒑 口
刀	刀
娘	女 丶 艮
降	阝 夂 㐄
恶	亚 心
宣	宀 一 旦
慢	忄 日 罒 又
积	禾 只
草	草
恐	工 凡 心
妈	女 马
读	讠 卖字头 冬字底 大
靠	告字头 口 非
阶	阝 介
楚	林 疋
姐	女 且
爸	父 巴
执	执
呼	口 乊 于无横
协	十 力 横两点
洲	氵 横三点 川
巨	匸 叚右角
免	免五 儿
检	木 亼 应字心
养	养字头 乔字底
顾	厂 㔾 页
救	求 攵
份	亻 分
控	扌 穴 工
抗	扌 亠 几
著	艹 者
赵	走 乂
肯	止 青字底
露	雨头 足旁 各
换	扌 奂
登	癶 豆
伊	亻 尹
犯	犭 㔾
尚	尚
莫	莫
危	尔字头 厂 㔾
审	宀 日 丨
掉	扌 卢字头 早
亦	亠 亦字底
沙	氵 少
散	龷 青字底 攵
欧	区 欠
唐	唐
枪	木 全字头 㔾
宫	宀 吕
魔	麻 鬼
耳	耳
屋	尸 至
永	丶 永无点
孙	子 小
临	临字旁 临右角 临下角
圣	又 土
叶	口 十
毫	亮字头 毛
宋	宀 木
谢	讠 身 寸
讨	讠 寸
温	温字框 皿
嘴	口 此 角
航	舟 亠 几
毒	龶 母
呀	口 牙
野	里 予
逃	儿 率字腰 辶
托	扌 丿 七
伯	亻 白
索	索字头 糸
岛	鸟省 山
贵	贵字头 贝
顺	川 页
楼	木 娄
遇	日 禺字底 辶
良	丶 艮
朋	月 月
坏	土 不
亮	亮字头 几
户	户
景	景
烈	歹 刂 灬
闪	门 人
礼	礻 乛
艺	艹 乙
互	一 彑
丝	丝左角 丝左角 一
秘	禾 心 丿
渐	氵 车旁 斤
架	力 口 木
鱼	鱼
升	丿 廾
抓	扌 爪
监	览字头 皿
君	君
短	矢 豆
梦	林 夕
隐	阝 刍 心
困	囗 木
税	禾 丷 兄
洋	氵 羊
鬼	鬼
炮	火 包
舰	舟 见
付	亻 寸
诸	讠 者
货	化 贝
松	木 公
归	师字旁 彐
败	贝 攵
幸	土 南字心
概	木 即字旁 旡
寻	彐 寸
评	讠 平
吸	口 及
恩	囗 大 心
介	介
朱	丿 未
探	扌 㓁 木
县	且 厶
脱	月 丷 兄
移	禾 夕 夕
缺	缶 夬
画	一 田 凵
误	讠 口 天
翻	釆 田 羽
旁	立无横 冖 方
跳	足旁 儿 率字腰
藏	艹 臧字框 臣
春	春字头 日
睡	目 垂
吉	士 口
端	立 山 而
味	口 未
杂	九 朩
释	釆 又 举字底
雪	雨头 彐
遗	贵字头 贝 辶
款	士 示 欠
刺	木框 冂 刂
附	阝 亻 寸
爷	父 节字底
核	木 亥
央	见二 大
减	冫 戊 同字心
阴	阝 月
编	纟 户 扁字心
版	片 反字框 又
智	矢 口 日
齐	齐
雨	雨
徐	彳 全字头 余字底
鲁	鱼 日
仙	亻 山
湖	氵 古 月
钟	钅 中
蒙	荧字头 一 豕
丽	一 丽下角 丽下角
班	王 刀中 王
咱	口 自
康	广 隶字框 率字腰
损	扌 员
震	雨头 辰
借	亻 龷 日
固	囗 古
诗	讠 土 寸
镇	钅 直 八
吴	口 天
域	土 戈 口 一
均	土 勹 冫
秦	春字头 禾
妇	女 彐
鲜	鱼 羊
序	广 予
烟	火 囗 大
洞	氵 冂 同字心
猛	犭 子 皿
测	氵 贝 刂
练	纟 东二 拣字边无七
旧	丨 日
堂	尚头 土
笔	竹头 毛
饭	饣 反字框 又
顶	丁 页
灭	一 火
庄	广 土
括	扌 舌
怒	女 又 心
补	衤 卜
逐	豕 辶
毕	比 十
席	度字框 巾
禁	林 示
剧	居 刂
乡	乡
湾	氵 变字头 弓
卖	卖字头 冬字底 大
牛	牛
避	辟 辶
欲	谷 欠
弄	王 廾
忍	刀 丶 心
旅	旅字框 旅下角
暴	日 共 氺
虚	虍 业
额	宀 各 页
含	今 口
忘	亡 心
抱	扌 包
油	氵 由
肉	肉
输	车旁 亼 青字底 刂
洛	氵 各
祖	礻 且
缓	纟 爫 一 友
迎	卬字旁 卩 辶
虎	虎
票	覀 示
销	钅 尚字头 青字底
婚	女 氏 日
乃	乃
板	木 反字框 又
冰	冫 水
伸	亻 日 丨
录	录字头 氺
遍	户 扁字心 辶
虑	虍 心
宁	宀 丁
臣	臣
玩	王 元
熟	享字头 子 丸 灬
谷	谷
予	予
谋	讠 甘 木
炸	火 乍
叔	上 小 又
奥	向字框 米 大
狂	犭 王
亡	亡
港	氵 共 巳
庭	广 壬 廴
博	十 甫 寸
材	木 才
俄	亻 我
韩	龺 韦
混	温字框 比
词	讠 乛 同字心
盘	舟 皿
尊	酋 寸
寒	寒字头 冬字底
遭	一 曲 日 辶
训	讠 川
拍	扌 白
麻	麻
荣	荧字头 木
卷	龹 㔾
夏	丆 目 夂
谓	讠 田 青字底
凡	凡
私	禾 厶
厂	厂
丁	丁
骨	骨
牙	牙
休	亻 木
迫	白 辶
授	扌 爱字头 又
替	夫 夫 日
拥	扌 用
摆	扌 罒 去
默	黑 犬
勒	革 力
泽	氵 又 举字底
骑	马 大 可
疗	疒 了
睛	目 龶 青字底
店	广 占
载	十 戈 车旁
诺	讠 艹 左字框 口
健	亻 聿 廴
扬	扌 乛 横两撇
纸	纟 氏
透	禾 乃 辶
床	广 木
唯	口 隹
岸	山 厂 干
迅	乛 十 辶
尤	尤
稳	禾 刍 心
园	囗 元
徒	彳 走
伦	亻 仑
坦	土 旦
择	扌 又 举字底
蓝	艹 览字头 皿
握	扌 尸 至
抵	扌 氏 丶
姓	女 生
郑	关 阝
弱	弓 冫 弓 冫
软	车旁 欠
绿	纟 录字头 氺
叹	口 又
轮	车旁 仑
束	束
盖	美字头 皿
丈	一 㐅
篇	竹头 户 扁字心
午	卧人 十
窗	穴 囱
歌	可 可 欠
雄	左字框 厶 隹
森	木 林
醒	酉 日 生
伙	亻 火
残	歹 戋
戏	又 戈
妻	妻字头 女
折	扌 斤
甲	甲
啦	口 扌 立
套	大 镸
塔	土 艹 合
馆	饣 宀 㠯
秋	禾 火
梅	木 卧人 母
迷	米 辶
典	典字头 一 八
灯	火 丁
厉	厂 万
秀	禾 乃
扩	扌 广
曲	曲
努	女 又 力
潜	氵 夫 夫 日
街	行 圭
硬	石 更
宇	宀 一 于无横
哭	吅 犬
阻	阝 且
萨	艹 阝 产
纵	纟 从
喊	口 戊 同字心
搞	扌 高
冒	冒字头 目
罢	罒 去
盛	成三 戈无一 皿
塞	寒字头 土
妹	女 未
萧	艹 肀 乔字底 八
桌	卢字头 日 木
圆	囗 员
纷	纟 分
悲	非 心
鼓	壴 支
淡	氵 火 火
访	讠 方
础	石 屮 凵
杜	木 土
宽	宀 艹 见
拜	龵 拜字边
犹	犭 尤
抽	扌 由
刑	开 刂
偏	亻 户 扁字心
奔	大 十 廾
侵	亻 彐 冖 又
延	延字心 廴
懂	忄 艹 𡈼 旦
蒋	艹 丬 夕 寸
针	钅 十
抬	扌 厶 口
舞	舞字头 舛
赞	先 先 贝
侧	亻 贝 刂
赛	寒字头 贝
纯	纟 屯
申	日 丨
夺	大 寸
柳	木 卯
距	足旁 匸 叚右角
丹	丹
仿	亻 方
川	川
途	全字头 余字底 辶
曹	一 曲 日
购	贝 勹 厶
亿	亻 乙
乌	乌
胸	月 勹 凶
浪	氵 丶 艮
贝	贝
偷	亻 亼 青字底 刂
姆	女 母
竞	立 兄
茶	艹 全字头 朩
末	末
毁	臼 工 殳
烧	火 尧字头 丆 乛
伟	亻 韦
库	广 车
弃	充字头 廾
墙	土 丧字头 囗 口
雅	牙 隹
贸	留字头 贝
沿	氵 几 口
爆	火 日 共 氺
振	扌 辰
趣	走 耳 又
操	扌 口 吅 木
诚	讠 成三 戈无一
挑	扌 儿 率字腰
杰	木 灬
轰	车 双
盟	日 月 皿
勇	龴 甬字底 力
敬	艹 句 攵
恨	忄 艮
狗	犭 句
迹	亠 亦字底 辶
呆	口 木
疾	疒 矢
哲	扌 斤 口
促	亻 足
麦	麦
横	木 黄
丰	丰
闭	门 才
撤	扌 充字头 青字底 攵
析	木 斤
挂	扌 圭
彩	爫 木 彡
埃	土 厶 矢
召	刀 口
童	童
摩	麻 手
乘	禾框 北
符	竹头 亻 寸
筑	竹头 工 凡
眉	眉字框 目
侠	亻 夹
袭	龙 衣
孤	子 瓜
培	土 咅
耶	耳 阝
染	氵 九 木
稍	禾 尚字头 青字底
妙	女 少
凶	凶
页	页
戴	十 戈 田 共
洗	氵 先
络	纟 各
陷	阝 负字头 臼
植	木 直
厚	厂 日 子
措	扌 龷 日
瓦	瓦
援	扌 爫 一 友
汇	氵 匚
触	角 虫
售	隹 口
违	韦 辶
粮	米 丶 艮
泪	氵 目
彻	彳 七 刀
洪	氵 共
献	十 冂 南字心 犬
魂	云 鬼
抢	扌 全字头 㔾
玄	亠 幺
巧	工 丂
珠	王 丿 未
劲	经右角 工 力
彼	彳 皮
摸	扌 莫
凭	亻 壬 几
暂	车旁 斤 日
碰	石 䒑 业
皆	比 白
尖	小 大
忠	中 心
奉	春字头 举字底
享	享字头 子
聚	耳 又 乑
胆	月 旦
厅	厂 丁
闹	门 亠 巾
灰	左字框 火
津	氵 聿
倾	亻 比字旁 页
订	讠 丁
鸟	鸟
扑	扌 卜
孔	子 乛
汽	氵 气
吓	口 下
驻	马 主
督	上 小 又 目
凤	风省 又
紫	此 糸
妖	女 夭
凌	冫 土 八 夂
唱	口 日 日
梁	氵 刀 横两点 木
箭	竹头 䒑 青字底 刂
融	鬲 虫
殊	歹 丿 未
课	讠 果
莱	艹 来
奴	女 又
扫	扌 彐
肩	户 青字底
鼻	鼻
庆	广 大
镜	钅 音 儿
菜	艹 爫 木
恢	忄 左字框 火
御	彳 卸字旁 卩
烦	火 页
裁	十 戈 衣
估	亻 古
隔	阝 鬲
尸	尸
尾	尸 毛
仪	亻 丶 乂
瞧	目 隹 灬
迟	尺 辶
圈	囗 龹 㔾
译	讠 又 举字底
骂	吅 马
珍	王 全字头 彡
币	丿 巾
惨	忄 厶 大 彡
剩	禾框 北 刂
愈	亼 青字底 刂 心
飘	覀 示 风
荒	芒 荒字底
惯	忄 毌 贝
缘	纟 彑 豕省
曼	日 罒 又
舍	全字头 舍字底
季	禾 子
旗	旅字框 其
艾	艹 乂
牌	片 卑
恰	忄 合
废	广 发
腰	月 覀 女
腿	月 艮 辶
玛	王 马
累	田 糸
涉	氵 止 步字底
燕	廿 口 北字旁 匕 灬
朗	丶 即字旁 月
颗	果 页
签	竹头 亼 应字心
吹	口 欠
罚	罒 讠 刂
拒	扌 匸 叚右角
仰	亻 卬字旁 卩
描	扌 艹 田
杯	木 不
奖	丬 夕 大
奋	大 田
奶	女 乃
贫	分 贝
甘	甘
婆	氵 皮 女
繁	卧人 母 攵 糸
穷	穴 力
伏	亻 犬
幕	莫 巾
殿	尸 共 殳
沈	氵 冖 儿
绍	纟 刀 口
启	户 口
缩	纟 宀 亻 百
粗	米 且
弗	弗
患	口 中 心
仇	亻 九
债	亻 龶 贝
碎	石 亠 从 十
挺	扌 壬 廴
泰	春字头 氺
羊	羊
旋	旅字框 疋
晓	日 尧字头 丆 乛
障	阝 立 早
桥	木 夭 乔字底
仁	亻 二
郎	丶 即字旁 阝
孟	子 皿
讯	讠 乛 十
虫	虫
郭	享字头 子 阝
幻	幺 乛
赫	土 亦字底 土 亦字底
裂	歹 刂 衣
凝	冫 匕 矢 龴 疋
颜	产 彡 页
刊	干 刂
慈	䒑 幺 幺 心
吕	吕
昨	日 乍
辛	辛
役	彳 殳
逼	同字心 田 辶
泛	氵 丿 之
瑞	王 山 而
伴	亻 半
袁	土 口 衣省
翼	羽 田 共
舒	全字头 舍字底 予
宜	宀 且
偶	亻 日 禺字底
峰	山 夂 丰
径	彳 经右角 工
岂	山 己
潮	氵 龺 月
捕	扌 甫
辆	车旁 两
邪	牙 阝
症	疒 正
颇	皮 页
插	扌 千 臼
袋	亻 弋 衣
爬	爪 巴
掩	扌 大 电
霍	雨头 隹
浮	氵 爫 子
倍	亻 咅
壮	丬 士
豪	亮字头 豕
拔	扌 友 丶
拖	扌 卧人 也
渡	氵 度字框 又
悄	忄 尚字头 青字底
堆	土 隹
鸡	又 鸟
狼	犭 丶 艮
播	扌 釆 田
零	雨头 今 丶
躲	身 几 木
映	日 见二 大
灾	宀 火
尺	尺
俗	亻 谷
疯	疒 风
丧	丧字头 畏字底
冬	夂 冬字底
辩	辛旁 讠 辛
炎	火 火
咬	口 交
码	石 马
猜	犭 龶 青字底
壁	辟 土
艘	舟 臼 丨 又
滚	氵 衣框 公
贴	贝 占
赏	尚头 贝
劝	又 力
兽	丷 田 同字心
番	釆 田
哼	口 享字头 了
撞	扌 童
伍	亻 五
柔	矛 木
旦	旦
跃	足旁 夭
隆	阝 夂 一 生
魏	禾 女 鬼
狠	犭 艮
糊	米 古 月
扎	扌 乛
忧	忄 尤
衡	行 衡字心
帐	巾 长
崇	山 宀 示
汗	氵 干
赖	束 尔字头 贝
薄	落字框 甫 寸
净	冫 尔字头 争字底
粉	米 分
岩	山 石
忆	忄 乙
堡	亻 口 木 土
巡	巛 辶
仔	亻 子
欣	斤 欠
偿	亻 龸 云
愤	忄 十 艹 贝
阁	门 各
详	讠 羊
喵	口 艹 田
竹	竹
漫	温字框 罒 又
爹	父 夕 夕
董	艹 𡈼 旦
撒	扌 龷 青字底 攵
佩	亻 风省 一 巾
丢	𡈼 厶
绕	纟 尧字头 丆 乛
赤	土 亦字底
扶	扌 夫
蛋	疋 虫
吐	口 土
返	反字框 又 辶
闲	门 木
陪	阝 咅
乔	夭 乔字底
盾	反字框 十 目
矿	石 广
矛	矛
耐	而 寸
焦	隹 灬
侍	亻 土 寸
拳	龹 手
墨	黑 土
允	厶 儿
侯	亻 候右角 矢
滑	氵 骨
润	氵 门 王
胞	月 包
邦	寿字头 阝
辈	非 车
井	井
荷	艹 亻 可
摄	扌 耳 双
署	罒 者
荡	落字框 乛 横两撇
敏	卧人 母 攵
递	丷 弓 弟省无弓 辶
泥	氵 尸 匕
骗	马 户 扁字心
曰	曰
彭	壴 彡
租	禾 且
晨	日 辰
搜	扌 臼 丨 又
昏	氏 日
幅	巾 同字心 田
奏	春字头 天
幽	山 幺 幺
兼	䒑 聿三 兼无䒑无彐
肃	肀 乔字底 八
艇	舟 壬 廴
辑	车旁 口 耳
枝	木 支
岳	丘无横 一 山
黎	禾 黎右角 全字头 氺
浓	氵 冖 衣省
酸	酉 厶 八 夂
污	氵 亏
凉	冫 京
辞	舌 辛
嘛	口 麻
戒	戈 廾
躺	身 尚
菲	艹 非
垂	垂
贯	毌 贝
炼	火 东二 拣字边无七
苍	艹 全字头 㔾
箱	竹头 相
驾	力 口 马
驱	马 区
凯	山 己 几
截	十 戈 隹
埋	土 里
拼	扌 丷 开
涌	氵 龴 甬字底
乏	丿 之
腾	月 龹 马
悉	釆 心
冯	冫 马
诊	讠 全字头 彡
皱	刍 皮
桑	又 双 木
慧	丰 丰 彐 心
漂	氵 覀 示
蛇	虫 宀 匕
恭	共 恭字底
迪	由 辶
恋	变字头 心
侦	亻 卢字头 贝
钢	钅 冂 乂
氏	氏
贼	贝 戈 左字框
燃	火 然左角 犬 灬
饮	饣 欠
碍	石 旦 寸
韦	韦
尘	小 土
餐	歺 又 食
邓	又 阝
阅	门 丷 兄
液	氵 亠 亻 夜下角
欺	其 欠
呵	口 可
牵	大 冖 牛
综	纟 宀 示
俩	亻 两
踪	足旁 宀 示
殖	歹 直
趋	走 刍
磨	麻 石
绪	纟 者
锁	钅 尚字头 贝
陶	阝 勹 缶
蒂	艹 立无横 冖 巾
慌	忄 芒 荒字底
臂	辟 青字底
慕	莫 恭字底
晋	亚 日
卢	卢字头 尸
惠	凬字心 虫无口 心
储	亻 讠 者
汤	氵 乛 横两撇
宪	宀 先
扰	扌 尤
宙	宀 由
聪	耳 兑字头 心
怨	夕 㔾 心
呈	口 王
跌	足旁 丿 夫
匆	勹 横两撇 丶
铺	钅 甫
脉	月 丶 永无点
锋	钅 夂 丰
劫	去 力
芳	艹 方
宾	宀 兵
帕	巾 白
盗	冫 欠 皿
佳	亻 圭
遵	酋 寸 辶
哦	口 我
幼	幺 力
仗	亻 一 㐅
伪	亻 丶 力 丶
驶	马 口 乂
腹	月 卧人 日 夂
牧	牜 攵
踏	足旁 水 日
惜	忄 龷 日
朵	几 木
袖	衤 由
胁	月 力 横两点
抛	扌 九 力
霸	雨头 革 月
媒	女 甘 木
频	止 步字底 页
勃	索字头 子 力
盯	目 丁
弯	变字头 弓
抚	扌 无
扭	扌 录字头 丨
册	册
励	厂 万 力
颤	亠 囗 口 旦 页
键	钅 聿 廴
勤	革 二 力
贡	工 贝
洁	氵 士 口
怜	忄 今 丶
寿	寿字头 寸
腊	月 龷 日
贺	力 口 贝
雾	雨头 夂 力
龄	齿 今 丶
椅	木 大 可
挤	扌 齐
扣	扌 口
届	尸 由
券	龹 刀
熊	厶 青字底 匕 匕 灬
尝	龸 云
询	讠 勹 日
喷	口 十 艹 贝
娇	女 夭 乔字底
夹	夹
肥	月 巴
祝	礻 兄
吾	五 口
寄	宀 大 可
疼	疒 夂 冬字底
斜	全字头 余字底 斗
拟	扌 以字旁 人
迁	千 辶
钻	钅 占
浑	氵 冖 车
肚	月 土
艰	又 艮
牢	宀 牛
惧	忄 具字头 八
挡	扌 尚字头 彐
敲	高 攴
庞	广 龙
叛	丷 夫三 反字框 又
鸣	口 鸟
柏	木 白
薛	艹 追字心 辛
屈	尸 屮 凵
叙	全字头 余字底 又
悟	忄 五 口
坡	土 皮
腐	广 亻 寸 肉
辽	了 辶
匹	匸 儿
铜	钅 冂 同字心
籍	竹头 耒 龷 日
穆	禾 白 小 彡
割	宀 丰 口 刂
旨	匕 日
擦	扌 宀 祭字头 示
沟	氵 勹 厶
抖	扌 斗
掠	扌 京
奈	大 示
泉	白 水
狱	犭 讠 犬
揭	扌 曷
晃	日 光
怔	忄 正
猎	犭 龷 日
诱	讠 禾 乃
娜	女 那字旁 阝
猫	犭 艹 田
醉	酉 亠 从 十
祭	祭字头 示
貌	豸 白 儿
池	氵 也
琴	王 王 今
寂	宀 上 小 又
遥	爫 缶 辶
瓶	丷 开 瓦
羽	羽
昆	日 比
辉	光 冖 车
吞	天 口
牲	牜 生
哀	衣框 口
昌	日 日
厌	厂 犬
晶	日 日 日
剂	齐 刂
绩	纟 龶 贝
筹	竹头 寿字头 寸
柱	木 主
搬	扌 舟 殳
莲	艹 车 辶
鹰	广 亻 隹 鸟
鞋	革 圭
俊	亻 厶 八 夂
恼	忄 㐫
瞪	目 癶 豆
俱	亻 具字头 八
稿	禾 高
搭	扌 艹 合
僧	亻 丷 曾字头无丷 日
纠	纟 丩
亏	亏
睁	目 尔字头 争字底
弥	弓 尔字头 小
践	足旁 戋
猪	犭 者
迈	万 辶
瘦	疒 臼 丨 又
浅	氵 戋
挣	扌 尔字头 争字底
逻	罒 夕 辶
宿	宀 亻 百
疲	疒 皮
邻	今 丶 阝
惑	戈 口 一 心
胖	月 半
丛	从 一
跪	足旁 尔字头 厂 㔾
傻	亻 囟 八 夂
贾	覀 贝
稀	禾 乂 左字框 巾
脏	月 广 土
慰	尸 示 寸 心
廷	壬 廴
饰	饣 卧人 巾
鉴	览字头 金
贷	亻 弋 贝
祥	礻 羊
葛	艹 曷
冠	冖 元 寸
跨	足旁 大 亏
耗	耒 毛
赔	贝 咅
悬	且 厶 心
仲	亻 中
拦	扌 䒑 二
戈	戈
粒	米 立
遣	贵字头 㠯 辶
捉	扌 足
赢	赢字框 贝
拨	扌 发
傅	亻 甫 寸
仆	亻 卜
锦	钅 白 巾
趁	走 全字头 彡
贤	贤字头 贝
贪	今 贝
澳	氵 向字框 米 大
削	尚字头 青字底 刂
衰	衣框 口 一
扔	扌 乃
卓	卢字头 早
湿	温字框 业
瞬	目 爱字头 舛
桃	木 儿 率字腰
鼠	鼠
辖	车旁 宀 丰 口
遂	丷 豕 辶
闷	门 心
雕	周字框 土 口 隹
邮	由 阝
誉	兴 言
暖	日 爫 一 友
阔	门 氵 舌
乾	龺 卧人 乙
祸	礻 呙
押	扌 甲
枚	木 攵
梯	木 丷 弓 弟省无弓
豆	豆
歇	曷 欠
嫌	女 䒑 聿三 兼无䒑无彐
碗	石 宀 夕 㔾
涂	氵 全字头 余字底
挖	扌 穴 乙
抑	扌 卬字旁 卩
烂	火 䒑 二
契	丰 刀 大
娃	女 圭
循	彳 反字框 十 目
渔	氵 鱼
嘉	壴 力 口
丑	录字头 丨
赋	贝 一 弋 止
斤	斤
勾	勹 厶
寺	土 寸
吼	口 子 乛
坛	土 云
惟	忄 隹
邀	白 方 攵 辶
械	木 戈 廾
滴	氵 立无横 冂 古
赴	走 卜
堪	土 其 乛
帽	巾 冒字头 目
帅	师字旁 巾
逊	子 小 辶
傲	亻 敖字旁 攵
吨	口 屯
仓	全字头 㔾
浩	氵 告字头 口
寸	寸
姿	冫 欠 女
覆	覀 彳 卧人 日 夂
闯	门 马
愚	日 禺字底 心
痕	疒 艮
牺	牜 西
瑟	王 王 心 丿
唤	口 奂
赌	贝 者
庙	广 由
蔡	艹 祭字头 示
扁	户 扁字心
哩	口 里
煤	火 甘 木
玻	王 皮
汪	氵 王
苗	艹 田
峡	山 夹
敦	享字头 子 攵
逆	䒑 䶹 辶
纹	纟 文
宅	宀 丿 七
妥	爫 女
忌	己 心
郁	左字框 青字底 阝
笼	竹头 龙
盐	土 卜 皿
玲	王 今 丶
唇	辰 口
耀	光 羽 隹
慎	忄 直 八
秩	禾 丿 夫
涨	氵 弓 长
墓	莫 土
饿	饣 我
陵	阝 土 八 夂
羞	差字头 录字头 丨
恒	忄 一 旦
纽	纟 录字头 丨
弓	弓
糖	米 唐
锐	钅 丷 兄
缝	纟 夂 丰 辶
夸	大 亏
喘	口 山 而
碧	王 白 石
卧	臣 卜
宏	宀 左字框 厶
岗	山 冂 乂
惩	彳 正 心
谨	讠 革 二
疏	疏字旁 㐬
斥	斤 丶
滋	氵 䒑 幺 幺
串	口 中
漠	氵 莫
屏	尸 丷 开
悔	忄 卧人 母
溜	氵 留字头 田
挨	扌 厶 矢
档	木 尚字头 彐
雇	户 隹
扇	户 羽
蛮	变字头 虫
鸿	氵 工 鸟
歼	歹 千
砍	石 欠
欠	欠
糟	米 一 曲 日
添	氵 天 恭字底
柴	此 木
屠	尸 者
勉	免五 儿 力
肌	月 几
齿	齿
赐	贝 日 勹 横两撇
桂	木 圭
刷	尸 巾 刂
聊	耳 卯
捷	扌 一 聿三 龰
肝	月 干
喂	口 田 一 畏字底
舱	舟 全字头 㔾
啥	口 全字头 舍字底
唉	口 厶 矢
磁	石 䒑 幺 幺
茫	落字框 亡
嫁	女 宀 豕
乙	乙
嘿	口 黑
瓜	瓜
丘	丘无横 一
菌	艹 囗 禾
粹	米 亠 从 十
催	亻 山 隹
吩	口 分
披	扌 皮
履	尸 彳 卧人 日 夂
乳	爫 子 乛
煞	刍 攵 灬
廉	广 䒑 聿三 兼无䒑无彐
兹	䒑 幺 幺
儒	亻 雨头 而
扯	扌 止
狐	犭 瓜
姊	女 姊字边
缠	纟 广 里
伐	亻 戈
矮	矢 禾 女
姜	美字头 女
绘	纟 全字头 云
卿	卯字旁 即字旁 卩
斩	车旁 斤
穴	穴
肤	月 夫
陛	阝 比 土
鹏	月 月 鸟
肿	月 中
辅	车旁 甫
肖	尚字头 青字底
沃	氵 夭
巫	工 从
柄	木 一 内
罩	罒 卢字头 早
缴	纟 白 方 攵
潘	氵 釆 田
蜂	虫 夂 丰
窝	穴 呙
舌	舌
晴	日 龶 青字底
弘	弓 厶
隶	隶字框 率字腰
悠	修字旁 攵 心
耕	耒 井
爵	爫 罒 即字旁 寸
郡	君 阝
奸	女 干
绳	纟 黾
辨	辛旁 刀中 辛
溃	氵 贵字头 贝
婴	贝 贝 女
孝	耂 子
怖	忄 左字框 巾
丫	丷 丨
愁	禾 火 心
亭	亮字头 丁
携	扌 隹 乃
泄	氵 廿 乛
疫	疒 殳
谭	讠 覀 早
翠	羽 亠 从 十
霞	雨头 叚
惹	艹 左字框 口 心
酷	酉 告字头 口
癌	疒 口 吅 山
翰	龺 全字头 羽
昂	日 卬字旁 卩
劈	辟 刀
甜	舌 甘
棉	木 白 巾
剥	录字头 氺 刂
卑	卑
矣	厶 矢
袍	衤 包
轨	车旁 九
卜	卜
柯	木 可
吟	口 今
鞭	革 亻 更
宰	宀 辛
脖	月 索字头 子
俘	亻 爫 子
辱	辰 寸
尿	尸 水
莉	艹 禾 刂
咽	口 囗 大
臭	自 犬
吻	口 勹 横两撇
疆	弓 土 一 田 一 田 一
饱	饣 包
抹	扌 末
愣	忄 罒 方
凑	冫 春字头 天
芬	艹 分
朕	月 关
畏	田 一 畏字底
骤	马 耳 又 乑
禅	礻 丷 旦 丨
拾	扌 合
炉	火 户
渴	氵 曷
铃	钅 今 丶
妨	女 方
填	土 直 八
豫	予 象
劣	少 力
竭	立 曷
愉	忄 亼 青字底 刂
摔	扌 亠 幺 率字腰 十
览	览字头 见
顽	元 页
脆	月 尔字头 厂 㔾
吵	口 少
泡	氵 包
毅	立 豕省 殳
吊	口 巾
扮	扌 分
狄	犭 火
腔	月 穴 工
遮	度字框 灬 辶
鹿	鹿
肠	月 乛 横两撇
灌	氵 艹 吅 隹
夕	夕
址	土 止
壳	壳字头 几
氧	气 羊
屁	尸 比
饶	饣 尧字头 丆 乛
狭	犭 夹
摘	扌 立无横 冂 古
芒	芒
棋	木 其
讼	讠 公
杆	木 干
翁	公 羽
倘	亻 尚
胃	田 青字底
拆	扌 斤 丶
盒	合 皿
驰	马 也
鲍	鱼 包
纲	纟 冂 乂
璃	王 㐫 禸
艳	丰 尔字头 巴
匪	匚 非
蓄	艹 亠 幺 田
妄	亡 女
姚	女 儿 率字腰
漏	氵 尸 雨
秒	禾 少
柜	木 匸 叚右角
掏	扌 勹 缶
函	了 率字腰 凵
哎	口 艹 乂
於	方 全字头 冬字底
裤	衤 广 车
猴	犭 亻 候右角 矢
枯	木 古
喉	口 亻 候右角 矢
悦	忄 丷 兄
痴	疒 矢 口
畜	亠 幺 田
衫	衤 彡
寨	寒字头 朩
誓	扌 斤 言
翅	支 羽
膀	月 立无横 冖 方
钦	钅 欠
纤	纟 千
厨	厂 豆 寸
撑	扌 尚头 手
宴	宀 日 女
锅	钅 呙
涛	氵 寿字头 寸
淮	氵 隹
盈	乃 又 皿
胎	月 厶 口
崩	山 月 月
拐	扌 另
轩	车旁 干
茨	艹 冫 欠
盆	分 皿
崖	山 厂 圭
砸	石 匚 巾
刹	乂 朩 刂
姬	女 颐字旁
晕	日 冖 车
赚	贝 䒑 聿三 兼无䒑无彐
囊	囊字头 吅 寒字腰 衣省
凄	冫 妻字头 女
膜	月 莫
葬	艹 歹 匕 廾
挽	扌 免五 儿
耸	从 耳
脾	月 卑
诞	讠 延字心 廴
懒	忄 束 尔字头 贝
妃	女 己
斑	王 文 王
崔	山 隹
後	彳 幺 夂
嫂	女 臼 丨 又
颠	直 八 页
棵	木 果
佐	亻 左字框 工
尉	尸 示 寸
陡	阝 走
眨	目 丿 之
陀	阝 宀 匕
陕	阝 夹
蜜	宀 心 丿 虫
饲	饣 乛 同字心
肺	月 丙三 丨
颈	经右角 工 页
眠	目 民
喃	口 十 冂 南字心
撕	扌 其 斤
驳	马 乂 乂
摊	扌 又 隹
朴	木 卜
拘	扌 句
朔	䒑 䶹 月
酬	酉 横三点 川
爪	爪
寇	宀 元 攴
岭	山 今 丶
裕	衤 谷
僵	亻 一 田 一 田 一
卵	卵
盼	目 分
赠	贝 丷 曾字头无丷 日
狮	犭 师字旁 一 巾
逝	扌 斤 辶
藤	艹 月 龹 氺
湘	氵 相
棍	木 日 比
堵	土 者
歪	不 正
冻	冫 东二 小
窃	穴 七 刀
俯	亻 广 亻 寸
虹	虫 工
陌	阝 百
骄	马 夭 乔字底
甫	甫
盲	亡 目
姻	女 囗 大
畅	日 丨 乛 横两撇
拓	扌 石
啸	口 肀 乔字底 八
抄	扌 少
昭	日 刀 口
猩	犭 日 生
拱	扌 共
摧	扌 山 隹
菩	艹 咅
蓬	艹 夂 丰 辶
铭	钅 夕 口
浙	氵 扌 斤
洒	氵 西
氛	气 分
饥	饣 几
踢	足旁 日 勹 横两撇
璇	王 旅字框 疋
泊	氵 白
琼	王 京
锡	钅 日 勹 横两撇
滩	氵 又 隹
捧	扌 春字头 举字底
讶	讠 牙
咳	口 亥
嘱	口 尸 丿 口 禺字底
绵	纟 白 巾
筒	竹头 冂 同字心
冈	冂 乂
萍	落字框 平
挪	扌 那字旁 阝
辟	辟
歧	止 支
钩	钅 勹 厶
芝	艹 之
谅	讠 京
逢	夂 丰 辶
鼎	目 鼎字框
廊	广 丶 即字旁 阝
吁	口 一 于无横
栏	木 䒑 二
巾	巾
罕	㓁 干
链	钅 车 辶
溪	氵 爫 幺 大
趟	走 尚
坑	土 亠 几
躯	身 区
吏	同字心 乂
歉	䒑 聿三 兼无䒑无彐 欠
沾	氵 占
妮	女 尸 匕
筋	竹头 月 力
殷	㐆 殳
坠	阝 人 土
棒	木 春字头 举字底
渊	氵 丿 米 丨
匠	匚 斤
耍	而 女
葡	艹 勹 甫
寡	宀 頁 刀
捏	扌 日 土
鸭	甲 鸟
冤	冖 兔
钉	钅 丁
舟	舟
瞎	目 宀 丰 口
笨	竹头 本
辰	辰
瞒	目 艹 两
剪	䒑 青字底 刂 刀
耻	耳 止
漆	氵 木 全字头 氺
阎	门 负字头 臼
骇	马 亥
擅	扌 亠 囗 口 旦
孕	乃 子
诡	讠 尔字头 厂 㔾
莎	落字框 少
昔	龷 日
蠢	春字头 日 虫 虫
宠	宀 龙
茅	艹 矛
谦	讠 䒑 聿三 兼无䒑无彐
淋	氵 林
账	贝 长
胶	月 交
玑	王 几
胀	月 长
庸	广 肀 甬字底
乞	卧人 乙
媚	女 眉字框 目
衙	行 五 口
膝	月 木 全字头 氺
逮	隶字框 率字腰 辶
宛	宀 夕 㔾
翔	差字头 羽
夷	大框 弓
骚	马 又 丶 虫
荆	艹 开 刂
杭	木 亠 几
裸	衤 果
乖	千 北
姨	女 大框 弓
哑	口 亚
嚷	口 衣框 吅 寒字腰
旺	日 王
叉	又 丶
恍	忄 光
惶	忄 白 王
咒	吅 几
镖	钅 覀 示
亨	享字头 了
窜	穴 口 中
杖	木 一 㐅
蝶	虫 廿 乛 木
逸	兔 辶
恕	女 口 心
搏	扌 甫 寸
焰	火 负字头 臼
绣	纟 禾 乃
禧	礻 壴 口
淫	氵 爫 壬
丐	丅 一 乛
碑	石 卑
鹅	我 鸟
蒲	落字框 甫
阐	门 丷 旦 丨
轿	车旁 夭 乔字底
伞	全字头 丷 十
蔽	艹 㡀 攵
咐	口 亻 寸
兆	儿 率字腰
爽	大框 乂 乂 乂 乂
豹	豸 勹 丶
弦	弓 亠 幺
薪	艹 亲 斤
冥	冖 日 六
捐	扌 口 青字底
谎	讠 芒 荒字底
愧	忄 鬼
衷	衣框 中
倏	修字旁 夂 犬
猿	犭 土 口 衣省
哇	口 圭
粘	米 占
栽	十 戈 木
浦	氵 甫
掀	扌 斤 欠
脂	月 匕 日
嘲	口 龺 月
框	木 匚 王
矩	矢 匸 叚右角
龟	龟
叠	又 双 冖 且
谊	讠 宀 且
脊	率字腰 人 青字底
刮	舌 刂
兔	兔
哨	口 尚字头 青字底
娶	耳 又 女
聘	耳 由 丂
慨	忄 即字旁 旡
俺	亻 大 电
嗓	口 又 双 木
舅	臼 田 力
寓	宀 日 禺字底
戚	戊 上 小
仑	仑
恳	艮 心
瘤	疒 留字头 田
掘	扌 尸 屮 凵
浴	氵 谷
倡	亻 日 日
裹	衣框 果
圳	土 川
渠	氵 匸 叚右角 木
钓	钅 勹 丶
涵	氵 了 率字腰 凵
泼	氵 发
瓷	冫 欠 瓦
祈	礻 斤
窄	穴 乍
拂	扌 弗
巢	巛 果
贞	卢字头 贝
纱	纟 少
绑	纟 寿字头 阝
茂	艹 戊
砖	石 专
谱	讠 䒑 业 日
坟	土 文
噢	口 向字框 米 大
硕	石 页
侄	亻 至
蹲	足旁 酋 寸
甩	月 乛
匈	勹 凶
胳	月 各
躬	身 弓
徽	微字框无一 一 糸
邵	刀 口 阝
蜀	罒 勹 虫
篮	竹头 览字头 皿
竖	贤字头 立
颁	分 页
焉	正 与无横 灬
壶	壳字头 业
浸	氵 彐 冖 又
萄	艹 勹 缶
僚	亻 大 丷 日 小
玫	王 攵
桓	木 一 旦
攀	木 乂 乂 木 大 手
撰	扌 巳 巳 共
旬	勹 日
媳	女 自 心
嘻	口 壴 口
蒸	艹 氶 一 灬
裙	衤 君
滥	氵 览字头 皿
愕	忄 吅 亏
讽	讠 风
霜	雨头 相
诏	讠 刀 口
躁	足旁 口 吅 木
厘	厂 里
憾	忄 戊 同字心 心
帘	穴 巾
巷	共 巳
溶	氵 宀 谷
亩	亠 田
勋	员 力
晰	日 木 斤
滞	氵 带字头 冖 巾
舆	臼裂 车 一 八
咸	戊 同字心
衔	行 钅
邱	丘无横 一 阝
挫	扌 从 土
搁	扌 门 各
桩	木 广 土
雀	小 隹
辣	辛旁 束
诧	讠 宀 丿 七
哗	口 化 十
屡	尸 娄
喻	口 亼 青字底 刂
窑	穴 缶
踩	足旁 爫 木
鸦	牙 鸟
郊	交 阝
株	木 丿 未
秃	禾 几
厦	厂 丆 目 夂
禄	礻 录字头 氺
卒	亠 从 十
丸	丸
聂	耳 双
雁	厂 亻 隹
琳	王 林
虏	虍 力
汝	氵 女
肢	月 支
咕	口 古
耽	耳 冖 儿
咖	口 力 口
煌	火 白 王
肆	镸 聿
哄	口 共
弊	㡀 攵 廾
耿	耳 火
叮	口 丁
倦	亻 龹 㔾
腺	月 白 水
彪	虎 彡
鹤	冖 隹 鸟
尴	尢 览字头 皿
巩	工 凡
焚	林 火
饼	饣 丷 开
鄙	口 十 囗 口 阝
拢	扌 龙
瞄	目 艹 田
勿	勹 横两撇
菊	艹 勹 米
厢	厂 相
腕	月 宀 夕 㔾
斋	文 而
诈	讠 乍
呜	口 乌
怯	忄 去
铸	钅 寿字头 寸
诀	讠 夬
绢	纟 口 青字底
魄	白 鬼
婉	女 宀 夕 㔾
兜	白 卬字旁 叚右角 儿
涅	温字框 土
禀	亠 囗 口 示
驴	马 户
垄	龙 土
擒	扌 全字头 㐫 禸
囚	囗 人
捞	扌 荧字头 力
舶	舟 白
倚	亻 大 可
喀	口 宀 各
贱	贝 戋
冀	北 田 共
稣	鱼 禾
厄	厂 㔾
溢	氵 益字头 皿
炭	山 左字框 火
稽	禾 尤 匕 日
渗	氵 厶 大 彡
泣	氵 立
罐	缶 艹 吅 隹
螺	虫 田 糸
衍	行 氵
狡	犭 交
桶	木 龴 甬字底
塌	土 日 羽
卸	卸字旁 卩
嘶	口 其 斤
帆	巾 凡
侨	亻 夭 乔字底
逗	豆 辶
昧	日 未
蓦	莫 马
坎	土 欠
棺	木 宀 㠯
荐	艹 在字框 子
雌	止 比字旁 隹
棚	木 月 月
靖	立 龶 青字底
裴	非 衣
栖	木 西
钧	钅 勹 冫
贩	贝 反字框 又
啡	口 非
衬	衤 寸
兑	丷 兄
榜	木 立无横 冖 方
魁	鬼 斗
谜	讠 米 辶
毙	比 歹 匕
麽	麻 丿 厶
瞥	㡀 攵 目
纺	纟 方
掷	扌 关 阝
肾	贤字头 青字底
烛	火 虫
谬	讠 羽 全字头 彡
锻	钅 段字旁 殳
芦	艹 户
膨	月 壴 彡
珊	王 册
刃	刀 丶
隙	阝 小 日 小
垒	厶 厶 厶 土
嫩	女 束 攵
钥	钅 月
塘	土 唐
韵	音 勹 冫
旱	日 干
咨	冫 欠 口
喇	口 束 刂
驼	马 宀 匕
颂	公 页
譬	辟 言
尹	尹
傍	亻 立无横 冖 方
坊	土 方
哟	口 纟 勹 丶
忖	忄 寸
霉	雨头 卧人 母
苹	艹 平
佣	亻 用
搂	扌 娄
堤	土 是
怡	忄 厶 口
淘	氵 勹 缶
谍	讠 廿 乛 木
藩	落字框 釆 田
贬	贝 丿 之
斧	父 斤
俞	亼 青字底 刂
糕	米 美字头 灬
颖	匕 禾 页
砰	石 平
稻	禾 爫 臼
熙	颐字旁 巳 灬
盏	戋 皿
棠	尚头 木
黯	黑 音
襄	衣框 吅 寒字腰
烤	火 耂 丂
詹	尔字头 厂 八 言
煮	者 灬
魅	鬼 未
蕴	艹 纟 日 皿
谐	讠 比 白
谕	讠 亼 青字底 刂
骆	马 各
捆	扌 囗 木
剿	巛 果 刂
枕	木 冖 儿
轴	车旁 由
笛	竹头 由
挟	扌 夹
逾	亼 青字底 刂 辶
咧	口 歹 刂
斌	文 一 弋 止
捡	扌 亼 应字心
壤	土 衣框 吅 寒字腰
黛	亻 弋 黑
沼	氵 刀 口
辐	车旁 同字心 田
娱	女 口 天
淑	氵 上 小 又
淹	氵 大 电
窦	穴 卖字头 冬字底 大
呐	口 内
灿	火 山
迦	力 口 辶
绅	纟 日 丨
禽	全字头 㐫 禸
犬	犬
倩	亻 龶 青字底
彦	产 彡
伽	亻 力 口
蹄	足旁 立无横 冖 巾
枢	木 区
啪	口 扌 白
妾	妾
搅	扌 学无子 见
汁	氵 十
凛	冫 亠 囗 口 示
羡	美字头 冫 欠
伺	亻 乛 同字心
蚁	虫 丶 乂
剖	咅 刂
幢	巾 童
瞅	目 禾 火
绞	纟 交
俏	亻 尚字头 青字底
娟	女 口 青字底
奢	大 者
膊	月 甫 寸
谴	讠 贵字头 㠯 辶
丙	一 内
滨	氵 宀 兵
窥	穴 夫 见
斐	非 文
祷	礻 寿字头 寸
藉	艹 耒 龷 日
敞	尚 攵
厮	厂 其 斤
咯	口 各
凰	风省 白 王
顷	比字旁 页
沸	氵 弗
绸	纟 周字框 土 口
椎	木 隹
莹	荧字头 玉
垫	执 土
廖	广 羽 全字头 彡
捣	扌 鸟省 山
叩	口 卩
蜡	虫 龷 日
侮	亻 卧人 母
眸	目 厶 牛
逛	犭 王 辶
芙	艹 夫
炒	火 少
谣	讠 爫 缶
沫	氵 末
咋	口 乍
屯	屯
屑	尸 尚字头 青字底
瑰	王 鬼
峻	山 厶 八 夂
喧	口 宀 一 旦
晒	日 西
莽	艹 犬 廾
矢	矢
熬	敖字旁 攵 灬
龚	龙 共
撇	扌 㡀 攵
梳	木 㐬
醇	酉 享字头 子
辜	古 辛
迄	卧人 乙 辶
匙	是 匕
嫉	女 疒 矢
睹	目 者
镑	钅 立无横 冖 方
诵	讠 龴 甬字底
嗅	口 自 犬
痒	疒 羊
栗	覀 木
颊	夹 页
缅	纟 面
缚	纟 甫 寸
妒	女 户
樱	木 贝 贝 女
麟	鹿旁 米 舛
逍	尚字头 青字底 辶
潭	氵 覀 早
芯	艹 心
郝	土 亦字底 阝
蛛	虫 丿 未
凳	癶 豆 几
堕	阝 左字框 青字底 土
揉	扌 矛 木
婢	女 卑
梭	木 厶 八 夂
嗣	口 扁字心 乛 同字心
虞	虍 口 天
垃	土 立
妓	女 支
勘	其 乛 力
篷	竹头 夂 丰 辶
乍	乍
桐	木 冂 同字心
缕	纟 娄
叱	口 化字边
鲸	鱼 京
贿	贝 左字框 青字底
趴	足旁 八
朽	木 丂
硅	石 圭
奎	大 圭
钞	钅 少
磕	石 去 皿
瑶	王 爫 缶
隋	阝 左字框 工 青字底
憎	忄 丷 曾字头无丷 日
蔑	艹 罒 戊 丶
馨	士 眉字框 殳 禾 日
杏	木 口
栋	木 东二 小
昼	尺 旦
苟	艹 句
腥	月 日 生
萝	艹 罒 夕
弩	女 又 弓
碌	石 录字头 氺
寝	宀 丬 彐 冖 又
倭	亻 禾 女
垮	土 大 亏
岚	山 风
燥	火 口 吅 木
姥	女 老
沦	氵 仑
兀	丆 乛
铅	钅 几 口
砂	石 少
兮	八 丂
牟	厶 牛
哉	十 戈 口
浆	丬 夕 水
虐	虍 虐字底
嗡	口 公 羽
旷	日 广
沮	氵 且
帖	巾 占
诛	讠 丿 未
鳞	鱼 米 舛
涯	氵 厂 圭
遁	反字框 十 目 辶
澄	氵 癶 豆
锤	钅 垂
滔	氵 爫 臼
寞	宀 莫
妆	丬 女
蹦	足旁 山 月 月
阮	阝 元
募	莫 力
敷	甫 方 攵
眯	目 米
汹	氵 凶
嘟	口 者 阝
霆	雨头 壬 廴
褐	衤 曷
畴	田 寿字头 寸
蚕	天 虫
嚼	口 爫 罒 即字旁 寸
奠	酋 大
榴	木 留字头 田
拙	扌 屮 凵
蚀	饣 虫
荫	艹 阝 月
鸽	合 鸟
咦	口 大框 弓
甸	勹 田
吱	口 支
暮	莫 日
泌	氵 心 丿
挠	扌 尧字头 丆 乛
叭	口 八
灶	火 土
峨	山 我
蓉	艹 宀 谷
菱	艹 土 八 夂
稚	禾 隹
澡	氵 口 吅 木
蔓	艹 日 罒 又
泻	氵 冖 与
裘	求 衣
溅	氵 贝 戋
丞	氶 一
秉	禾框 聿三
绒	纟 戈 左字框
遏	曷 辶
彬	林 彡
熄	火 自 心
朦	月 荧字头 一 豕
琢	王 豕 丶
膏	高头 青字底
凿	业 南字心 凵
泳	氵 丶 永无点
敛	亼 应字心 攵
庐	广 户
惭	忄 车旁 斤
畔	田 半
沧	氵 全字头 㔾
酿	酉 丶 艮
阀	门 亻 戈
虔	虍 文
侣	亻 吕
匀	勹 冫
拯	扌 氶 一
莺	荧字头 鸟
屿	山 与
沪	氵 户
叟	臼 丨 又
藻	落字框 口 吅 木
雍	亠 乡 隹
瘫	疒 又 隹
蹈	足旁 爫 臼
揽	扌 览字头 见
氢	气 经右角 工
豁	宀 丰 口 谷
骸	骨 亥
陋	阝 一 内 乛
捂	扌 五 口
冶	冫 厶 口
懈	忄 角 刀 牛
坪	土 平
蔬	艹 疏字旁 㐬
翘	尧字头 丆 乛 羽
嘎	口 丆 目 戈
缔	纟 立无横 冖 巾
娥	女 我
讥	讠 几
钮	钅 录字头 丨
晤	日 五 口
灼	火 勹 丶
舵	舟 宀 匕
纬	纟 韦
圾	土 及
澜	氵 门 束 丷
茎	艹 经右角 工
鄂	吅 亏 阝
歹	歹
邹	刍 阝
枉	木 王
琉	王 㐬
庇	广 比
杉	木 彡
跋	足旁 友 丶
梢	木 尚字头 青字底
戳	羽 隹 戈
蝉	虫 丷 旦 丨
毯	毛 火 火
萎	艹 禾 女
裳	尚头 衣
绰	纟 卢字头 早
佑	亻 左字框 口
拚	扌 厶 廾
狸	犭 里
窟	穴 尸 屮 凵
硫	石 㐬
腻	月 弋 二 贝
憋	㡀 攵 心
凹	凹无横 一
赎	贝 卖字头 冬字底 大
崎	山 大 可
烁	火 乐二 小
嚣	吅 页 吅
焕	火 奂
暑	日 者
扛	扌 工
匕	匕
揣	扌 山 而
凸	凸无横 一
怠	厶 口 心
觅	爫 见
呕	口 区
孽	艹 追字心 辛 子
楞	木 罒 方
矫	矢 夭 乔字底
潇	氵 艹 肀 乔字底 八
簇	竹头 旅字框 矢
浇	氵 尧字头 丆 乛
枣	木框 冂 冬字底
绥	纟 爫 女
芽	艹 牙
蝇	虫 黾
僻	亻 辟
榻	木 日 羽
宦	宀 臣
沐	氵 木
毋	毋
碟	石 廿 乛 木
仕	亻 士
戎	戈 左字框
呻	口 日 丨
啼	口 立无横 冖 巾
虾	虫 下
樊	木 乂 乂 木 大
棕	木 宀 示
萌	艹 日 月
嫣	女 正 与无横 灬
伶	亻 今 丶
鞘	革 尚字头 青字底
删	册 刂
嵌	山 甘 欠
暇	日 叚
蛟	虫 交
茵	艹 囗 大
驯	马 川
炕	火 亠 几
碳	石 山 左字框 火
烫	氵 乛 横两撇 火
咚	口 夂 冬字底
苑	艹 夕 㔾
蚂	虫 马
厥	厂 䒑 䶹 欠
雯	雨头 文
赦	土 亦字底 攵
慷	忄 广 隶字框 率字腰
旭	九 日
煎	䒑 青字底 刂 灬
惕	忄 日 勹 横两撇
颓	禾 几 页
坝	土 贝
悍	忄 日 干
匿	匚 艹 左字框 口
噪	口 口 吅 木
涡	氵 呙
禹	丿 口 禺字底
敝	㡀 攵
簿	竹头 氵 甫 寸
缸	缶 工
坤	土 日 丨
琐	王 尚字头 贝
蚊	虫 文
粟	覀 米
诫	讠 戈 廾
髓	骨 左字框 工 青字底 辶
梵	林 凡
溯	氵 䒑 䶹 月
蝴	虫 古 月
尬	尢 介
涩	氵 刀 丶 止
揪	扌 禾 火
窘	穴 君
棘	木框 冂 木框 冂
盔	左字框 火 皿
喔	口 尸 至
婶	女 宀 日 丨
踱	足旁 度字框 又
嗜	口 老 日
啤	口 卑
哺	口 甫
奕	亠 亦字底 大
淳	氵 享字头 子
晌	日 向字框 口
镶	钅 衣框 吅 寒字腰
粪	米 共
铲	钅 产
瑜	王 亼 青字底 刂
冢	冖 豕 丶
唾	口 垂
庵	广 大 电
扼	扌 厂 㔾
聋	龙 耳
庚	广 聿三 人
膛	月 尚头 土
疤	疒 巴
叨	口 刀
佟	亻 夂 冬字底
绷	纟 月 月
棱	木 土 八 夂
慑	忄 耳 双
筷	竹头 忄 夬
庶	度字框 灬
沁	氵 心
渺	氵 目 少
迂	一 于无横 辶
梨	禾 刂 木
拣	扌 东二 拣字边无七
葫	艹 古 月
浏	氵 文 刂
橡	木 象
扳	扌 反字框 又
嘘	口 虍 业
牡	牜 土
贮	贝 宀 一
窍	穴 工 丂
襟	衤 林 示
眷	龹 目
弧	弓 瓜
癫	疒 直 八 页
葱	艹 勹 横两撇 丶 心
熏	千 黑
噗	口 业 养字头
炯	火 冂 口
稼	禾 宀 豕
鞠	革 勹 米
栅	木 册
塑	䒑 䶹 月 土
霎	雨头 妾
匣	匚 甲
厕	厂 贝 刂
眩	目 亠 幺
岔	分 山
缆	纟 览字头 见
谏	讠 束 丷
呃	口 厂 㔾
唔	口 五 口
懿	壳字头 豆 冫 欠 心
斟	其 乛 斗
拧	扌 宀 丁
嗤	口 屮 一 虫
磅	石 立无横 冖 方
尧	尧字头 丆 乛
鳍	鱼 老 日
肘	月 寸
帜	巾 只
晦	日 卧人 母
搓	扌 差字头 工
粥	弓 米 弓
枫	木 风
琪	王 其
裔	衣 𠕉字底 口
彰	立 早 彡
瞻	目 尔字头 厂 八 言
邑	邑
吭	口 亠 几
垣	土 一 旦
嗽	口 束 欠
皓	白 告字头 口
竿	竹头 干
嚎	口 亮字头 豕
拽	扌 曳无丿 丿
倪	亻 臼 儿
胧	月 龙
峭	山 尚字头 青字底
攸	修字旁 攵
瓣	辛旁 瓜 辛
忿	分 心
扒	扌 八
嘀	口 立无横 冂 古
桨	丬 夕 木
锥	钅 隹
梗	木 更
夭	夭
蹬	足旁 癶 豆
俭	亻 亼 应字心
淌	氵 尚
廓	广 享字头 子 阝
浊	氵 虫
碱	石 戊 同字心
迭	丿 夫 辶
讳	讠 韦
逞	口 王 辶
邸	氏 丶 阝
撼	扌 戊 同字心 心
檀	木 亠 囗 口 旦
磷	石 米 舛
踉	足旁 丶 艮
娅	女 亚
绽	纟 定
哆	口 夕 夕
诬	讠 工 从
靴	革 化
冉	冉
芸	艹 云
奚	爫 幺 大
宵	宀 尚字头 青字底
戟	龺 戈
札	木 乛
蛙	虫 圭
擎	艹 句 攵 手
沛	氵 丙三 丨
硝	石 尚字头 青字底
崛	山 尸 屮 凵
槽	木 一 曲 日
喽	口 娄
礁	石 隹 灬
哮	口 耂 子
腮	月 田 心
蜘	虫 矢 口
妞	女 录字头 丨
刁	乛 一
栓	木 全字头 王
熔	火 宀 谷
懊	忄 向字框 米 大
侥	亻 尧字头 丆 乛
炽	火 只
铮	钅 尔字头 争字底
鞑	革 大 辶
胚	月 不 一
敖	敖字旁 攵
苛	艹 可
迸	丷 开 辶
轼	车旁 弋 工
祁	礻 阝
拇	扌 母
窒	穴 至
邢	开 阝
酌	酉 勹 丶
悼	忄 卢字头 早
柬	束 丷
瑛	王 艹 见二 大
掐	扌 负字头 臼
颐	颐字旁 页
猝	犭 亠 从 十
缀	纟 双 双
锣	钅 罒 夕
饷	饣 向字框 口
卦	圭 卜
壕	土 亮字头 豕
噬	口 竹头 工 从
絮	女 口 糸
崭	山 车旁 斤
馈	饣 贵字头 贝
霄	雨头 尚字头 青字底
荀	艹 勹 日
岑	山 今
褚	衤 者
墅	里 予 土
墟	土 虍 业
殆	歹 厶 口
涕	氵 丷 弓 弟省无弓
骏	马 厶 八 夂
矗	直 直 直
徘	彳 非
幡	巾 釆 田
釉	釆 由
嗔	口 直 八
煽	火 户 羽
醋	酉 龷 日
匡	匚 王
鞍	革 宀 女
袜	衤 末
寥	宀 羽 全字头 彡
槐	木 鬼
罡	罒 正
茜	艹 西
挚	执 手
缎	纟 段字旁 殳
薇	艹 微字框无一 一 几
闺	门 圭
湛	氵 其 乛
悯	忄 门 文
咆	口 包
毓	卧人 母 㐬
摹	莫 手
颅	卢字头 尸 页
陇	阝 龙
唬	口 虎
钙	钅 丅 一 乛
缪	纟 羽 全字头 彡
酱	丬 夕 酉
痰	疒 火 火
锯	钅 居
炫	火 亠 幺
霹	雨头 辟
杠	木 工
忒	弋 心
懦	忄 雨头 而
笃	竹头 马
翩	户 扁字心 羽
檐	木 尔字头 厂 八 言
婿	女 疋 青字底
搀	扌 免五 儿 冬字底
肋	月 力
垦	艮 土
汰	氵 太
捅	扌 龴 甬字底
蟹	角 刀 牛 虫
箫	竹头 肀 乔字底 八
拴	扌 全字头 王
羌	差字头 乛
嗦	口 索字头 糸
绊	纟 半
洽	氵 合
瀑	温字框 共 氺
珀	王 白
绎	纟 又 举字底
恃	忄 土 寸
蟒	虫 艹 犬 廾
驿	马 又 举字底
撩	扌 大 丷 日 小
掳	扌 虍 力
抒	扌 予
犀	尸 犀字心头 牛
芭	艹 巴
舷	舟 亠 幺
甄	覀 土 瓦
嫦	女 尚头 巾
拎	扌 今 丶
橱	木 厂 豆 寸
睦	目 土 八 土
臀	尸 共 殳 青字底
娴	女 门 木
粤	丿 囗 米 丂
蕊	艹 心 心 心
辫	辛旁 纟 辛
酋	酋
狞	犭 宀 丁
诅	讠 且
踌	足旁 寿字头 寸
坞	土 乌
渣	氵 木 旦
亥	亥
巍	山 禾 女 鬼
靡	麻 非
瘟	疒 日 皿
瞿	目 目 隹
惫	夂 田 心
陨	阝 员
脯	月 甫
骷	骨 古
肪	月 方
祀	礻 巳
祠	礻 乛 同字心
揖	扌 口 耳
剔	日 勹 横两撇 刂
膳	月 羊 䒑 口
叽	口 几
钝	钅 屯
缉	纟 口 耳
狙	犭 且
靶	革 巴
徊	彳 囗 口
氯	气 录字头 氺
疮	疒 全字头 㔾
蔚	艹 尸 示 寸
鹃	口 青字底 鸟
啃	口 止 青字底
皂	白 七
阙	门 䒑 䶹 欠
鲤	鱼 里
峙	山 土 寸
氨	气 宀 女
禺	日 禺字底
舔	舌 天 恭字底
骡	马 田 糸
闽	门 虫
秽	禾 山 夕
闵	门 文
咙	口 龙
瑚	王 古 月
嬉	女 壴 口
拭	扌 弋 工
肮	月 亠 几
佬	亻 老
狩	犭 宀 寸
紊	文 糸
咎	夂 卜 口
栈	木 戋
嗨	口 氵 卧人 母
殉	歹 勹 日
幌	巾 日 光
苔	艹 厶 口
嵩	山 高
篱	竹头 㐫 禸
剃	丷 弓 弟省无弓 刂
氓	亡 民
婷	女 亮字头 丁
昊	日 天
砌	石 七 刀
绫	纟 土 八 夂
佯	亻 羊
巳	巳
悖	忄 索字头 子
炳	火 一 内
呛	口 全字头 㔾
濒	氵 止 步字底 页
屎	尸 米
汀	氵 丁
瞟	目 覀 示
孜	子 攵
嵋	山 眉字框 目
犁	禾 刂 牛
揍	扌 春字头 天
苇	艹 韦
掺	扌 厶 大 彡
趾	足旁 止
酶	酉 卧人 母
榆	木 亼 青字底 刂
霖	雨头 林
韧	韦 刀 丶
拷	扌 耂 丂
侈	亻 夕 夕
肇	户 攵 聿
饵	饣 耳
舜	爱字头 舛
兢	古 儿 古 儿
臻	至 春字头 禾
擂	扌 雨头 田
猾	犭 骨
恤	忄 血
隘	阝 益字头 皿
忏	忄 千
蝗	虫 白 王
颔	今 口 页
绮	纟 大 可
琦	王 大 可
诩	讠 羽
钗	钅 又 丶
茄	艹 力 口
敕	束 攵
睿	歺头 谷字头 目
噜	口 鱼 日
跺	足旁 几 木
佃	亻 田
戮	羽 全字头 彡 戈
颉	士 口 页
铀	钅 由
倔	亻 尸 屮 凵
蕉	艹 隹 灬
褂	衤 圭 卜
溺	氵 弓 冫 弓 冫
谟	讠 莫
皖	白 宀 元
狈	犭 贝
噩	噩字框 吅 吅
糙	米 告字头 口 辶
瘾	疒 阝 刍 心
赁	亻 壬 贝
埔	土 甫
咄	口 屮 凵
畸	田 大 可
赣	立 早 夂 工 贝
樵	木 隹 灬
亢	亠 几
侃	亻 口 荒字底
嫡	女 立无横 冂 古
眶	目 匚 王
涤	氵 夂 朩
捻	扌 今 心
鸠	九 鸟
捍	扌 日 干
芜	艹 无
酥	酉 禾
屉	尸 廿 乛
眺	目 儿 率字腰
抿	扌 民
辙	车旁 充字头 青字底 攵
胤	丿 幺 青字底 乛
闸	门 甲
蛊	虫 皿
褪	衤 艮 辶
鳌	敖字旁 攵 鱼
彷	彳 方
翎	今 丶 羽
婪	林 女
衅	血 半
猖	犭 日 日
伎	亻 支
捶	扌 垂
梧	木 五 口
洼	氵 圭
吆	口 幺
椒	木 上 小 又
瞳	目 童
勺	勹 丶
卉	十 廾
竺	竹头 二
嗖	口 臼 丨 又
淀	氵 定
烘	火 共
痪	疒 奂
炊	火 欠
枭	鸟省 木
髦	镸 彡 毛
轧	车旁 乛
矶	石 几
钳	钅 甘
稠	禾 周字框 土 口
戊	戊
羁	罒 革 马
璋	王 立 早
咪	口 米
甭	不 用
颌	合 页
铝	钅 吕
谒	讠 曷
麾	麻 毛
驭	马 又
俨	亻 亚 丿
侬	亻 冖 衣省
疚	疒 久二 丶
憔	忄 隹 灬
晏	日 宀 女
驮	马 大
烙	火 各
赃	贝 广 土
怅	忄 长
搔	扌 又 丶 虫
磋	石 差字头 工
篡	竹头 目 大 厶
蹙	戊 上 小 足
毗	田 比
瞩	目 尸 丿 口 禺字底
笠	竹头 立
殴	区 殳
唠	口 荧字头 力
喳	口 木 旦
锄	钅 且 力
隧	阝 丷 豕 辶
剌	束 刂
憨	乛 耳 攵 心
菁	艹 龶 青字底
狰	犭 尔字头 争字底
桔	木 士 口
孵	卵 爫 子
蝠	虫 同字心 田
袅	鸟省 衣
滇	氵 直 八
疹	疒 全字头 彡
黝	黑 幺 力
汴	氵 亠 卜
缰	纟 一 田 一 田 一
酝	酉 云
垢	土 后字框 口
掣	牛 冂 刂 手
琅	王 丶 艮
嘈	口 一 曲 日
筛	竹头 师字旁 一 巾
谤	讠 立无横 冖 方
曙	日 罒 者
蕾	艹 雨头 田
漱	氵 束 欠
阱	阝 井
琵	王 王 比
胰	月 大框 弓
狒	犭 弗
哽	口 更
呸	口 不 一
廿	廿
睫	目 一 聿三 龰
蠕	虫 雨头 而
吠	口 犬
筐	竹头 匚 王
讪	讠 山
惺	忄 日 生
汲	氵 及
赂	贝 各
澈	氵 充字头 青字底 攵
酣	酉 甘
滤	氵 虍 心
徙	彳 止 龰
抡	扌 仑
惋	忄 宀 夕 㔾
漩	氵 旅字框 疋
孰	享字头 子 丸
睬	目 爫 木
哧	口 土 亦字底
椭	木 阝 左字框 青字底
钵	钅 本
笈	竹头 及
茹	艹 女 口
褒	衣框 亻 口 木
蛾	虫 我
啧	口 龶 贝
衲	衤 内
毡	毛 占
澎	氵 壴 彡
窖	穴 告字头 口
曳	曳无丿 丿
荧	荧字头 火
吝	文 口
谛	讠 立无横 冖 巾
跄	足旁 全字头 㔾
淆	氵 乂 左字框 青字底
菇	艹 女 古
诣	讠 匕 日
锈	钅 禾 乃
辗	车旁 尸 展字心
穗	禾 凬字心 虫无口 心
惰	忄 左字框 工 青字底
鲨	氵 少 鱼
柿	木 亠 巾
脓	月 冖 衣省
巅	山 直 八 页
啄	口 豕 丶
娄	娄
帷	巾 隹
簧	竹头 黄
琛	王 㓁 木
萤	荧字头 虫
奄	大 电
盎	见二 大 皿
渭	氵 田 青字底
馒	饣 日 罒 又
攘	扌 衣框 吅 寒字腰
鸾	变字头 鸟
忡	忄 中
嫖	女 覀 示
蝎	虫 曷
虬	虫 乛
鹦	贝 贝 女 鸟
桅	木 尔字头 厂 㔾
贻	贝 厶 口
咀	口 且
鞅	革 见二 大
翟	羽 隹
惚	忄 勹 横两撇 心
拈	扌 占
攒	扌 先 先 贝
沌	氵 屯
痊	疒 全字头 王
钊	钅 刂
髯	镸 彡 冉
烹	享字头 了 灬
豚	月 豕
咏	口 丶 永无点
腑	月 广 亻 寸
诘	讠 士 口
渎	氵 卖字头 冬字底 大
悚	忄 束
撮	扌 日 耳 又
磊	石 石 石
觑	虍 业 见
寅	宀 一 由 八
茸	艹 耳
忱	忄 冖 儿
亵	衣框 执
傀	亻 鬼
匾	匚 户 扁字心
弛	弓 也
疙	疒 卧人 乙
雏	刍 隹
弼	弓 百 弓
戍	戊 丶
帛	白 巾
缭	纟 大 丷 日 小
羹	美字头 灬 美字头 大
袄	衤 夭
迥	冂 口 辶
俟	亻 厶 矢
躇	足旁 艹 者
墩	土 享字头 子 攵
鸥	区 鸟
痉	疒 经右角 工
抨	扌 平
阜	追字心 十
禾	禾
曝	日 日 共 氺
乒	丘无横 一 丿
壬	壬
伢	亻 牙
孚	爫 子
隅	阝 日 禺字底
堑	车旁 斤 土
恪	忄 各
槛	木 览字头 皿
惦	忄 广 占
薯	艹 罒 者
驹	马 句
怦	忄 平
炙	然左角 火
恺	忄 山 己
蒜	艹 示 示
坍	土 丹
铠	钅 山 己
韶	音 刀 口
咔	口 上 卜
璧	辟 玉
驸	马 亻 寸
嗒	口 艹 合
霓	雨头 臼 儿
彝	彑 米 糸 廾
淤	氵 方 全字头 冬字底
抉	扌 夬
挛	变字头 手
捎	扌 尚字头 青字底
呱	口 瓜
袱	衤 亻 犬
惘	忄 冂 䒑 亡
糜	麻 米
蹑	足旁 耳 双
蹿	足旁 穴 口 中
桀	舛 木
聆	耳 今 丶
褥	衤 辰 寸
阑	门 束 丷
貂	豸 刀 口
梓	木 辛
蹭	足旁 丷 曾字头无丷 日
俾	亻 卑
漪	氵 犭 大 可
矜	矛 今
圭	圭
漓	氵 㐫 禸
穹	穴 弓
肛	月 工
诃	讠 可
诽	讠 非
蔼	艹 讠 曷
蕃	艹 釆 田
鬓	镸 彡 宀 兵
辄	车旁 耳 乛
恻	忄 贝 刂
阉	门 大 电
刨	包 刂
崽	山 田 心
瓢	覀 示 瓜
祟	屮 凵 示
幔	巾 日 罒 又
沽	氵 古
笋	竹头 尹
筝	竹头 尔字头 争字底
滕	月 龹 氺
炬	火 匸 叚右角
葵	艹 癶 天
铎	钅 又 举字底
恬	忄 舌
楷	木 比 白
袒	衤 旦
冕	冒字头 免五 儿
纶	纟 仑
疡	疒 乛 横两撇
埠	土 追字心 十
偌	亻 艹 左字框 口
蜈	虫 口 天
橙	木 癶 豆
涧	氵 门 日
煸	火 户 扁字心
瓒	王 先 先 贝
蝙	虫 户 扁字心
诲	讠 卧人 母
殃	歹 见二 大
痹	疒 田 丌
晖	日 冖 车
蜷	虫 龹 㔾
鸳	夕 㔾 鸟
噶	口 艹 曷
蘑	艹 麻 石
鹊	龷 日 鸟
碾	石 尸 展字心
珂	王 可
芮	艹 内
茧	艹 虫
羔	美字头 灬
靳	革 斤
堰	土 匚 日 女
悻	忄 土 南字心
曦	日 美字头 禾 丂 戈无一
黏	禾 全字头 氺 占
橄	木 乛 耳 攵
偕	亻 比 白
妩	女 无
腋	月 亠 亻 夜下角
暧	日 爱字头 友
涟	氵 车 辶
拗	扌 幺 力
憧	忄 童
胥	疋 青字底
芹	艹 斤
俸	亻 春字头 举字底
圃	囗 甫
薰	艹 千 黑
秧	禾 见二 大
拌	扌 半
邯	甘 阝
悸	忄 禾 子
锚	钅 艹 田
瑙	王 巛 囟
癸	癶 天
砾	石 乐二 小
磐	舟 殳 石
凋	冫 周字框 土 口
嬴	赢字框 女
溥	氵 甫 寸
亟	了 口 又 一
偎	亻 田 一 畏字底
橘	木 矛 𠕉字底 口
滢	氵 荧字头 玉
懵	忄 艹 罒 冖 目
唆	口 厶 八 夂
绚	纟 勹 日
胺	月 宀 女
嚓	口 宀 祭字头 示
撬	扌 毛 毛 毛
肴	乂 左字框 青字底
纂	竹头 目 大 糸
碉	石 周字框 土 口
蹊	足旁 爫 幺 大
忐	上 心
楠	木 十 冂 南字心
钠	钅 内
笺	竹头 戋
渲	氵 宀 一 旦
娼	女 日 日
暨	即字旁 旡 旦
湄	氵 眉字框 目
翡	非 羽
鳄	鱼 吅 亏
萃	艹 亠 从 十
枷	木 力 口
籽	米 子
韬	韦 爫 臼
骼	骨 各
潼	氵 童
祺	礻 其
笙	竹头 生
岐	山 支
悴	忄 亠 从 十
攥	扌 竹头 目 大 糸
喋	口 廿 乛 木
蜕	虫 丷 兄
聿	聿
氮	气 火 火
踹	足旁 山 而
釜	父 金字底
叼	口 乛 一
揩	扌 比 白
麓	林 鹿
嫔	女 宀 兵
劾	亥 力
辎	车旁 巛 田
翌	羽 立
乓	丘无横 一 丶
绯	纟 非
渤	氵 索字头 子 力
俐	亻 禾 刂
粱	氵 刀 横两点 米
腓	月 非
撵	扌 夫 夫 车
搐	扌 亠 幺 田
茬	艹 在字框 土
赘	敖字旁 攵 贝
龋	齿 丿 口 禺字底
瘪	疒 自 仑
遽	虍 豕 辶
饺	饣 交
怂	从 心
屹	山 卧人 乙
沥	氵 厂 力
辕	车旁 土 口 衣省
缜	纟 直 八
睾	丿 罒 土 南字心
讷	讠 内
蚤	又 丶 虫
锭	钅 定
榨	木 穴 乍
瑾	王 革 二
蛤	虫 合
攫	扌 目 目 隹 又
捋	扌 爫 寸
骥	马 北 田 共
瓮	公 瓦
惴	忄 山 而
汾	氵 分
溉	氵 即字旁 旡
妊	女 壬
惮	忄 丷 旦 丨
锌	钅 辛
馀	饣 全字头 余字底
帧	巾 卢字头 贝
撂	扌 田 各
酵	酉 耂 子
哒	口 大 辶
绛	纟 夂 㐄
冗	冖 几
磺	石 黄
赈	贝 辰
瀚	氵 龺 全字头 羽
跤	足旁 交
彗	丰 丰 彐
顼	王 页
簸	竹头 其 皮
雳	雨头 厂 力
愫	忄 龶 糸
镰	钅 广 䒑 聿三 兼无䒑无彐
掂	扌 广 占
擘	辟 手
谚	讠 产 彡
卤	卤
箍	竹头 扌 匚 巾
跛	足旁 皮
筵	竹头 延字心 廴
膺	广 亻 隹 青字底
桢	木 卢字头 贝
渝	氵 亼 青字底 刂
皈	白 反字框 又
漾	氵 美字头 丶 永无点
铢	钅 丿 未
啜	口 双 双
扈	户 邑
瘩	疒 艹 合
耆	老 日
锵	钅 丬 夕 寸
阪	阝 反字框 又
萦	荧字头 糸
囱	囱
暄	日 宀 一 旦
哝	口 冖 衣省
漳	氵 立 早
侏	亻 丿 未
栩	木 羽
藐	艹 豸 白 儿
吮	口 厶 儿
莞	艹 宀 元
砚	石 见
匮	匚 贵字头 贝
涣	氵 奂
潦	氵 大 丷 日 小
踞	足旁 居
秤	禾 平
浚	氵 厶 八 夂
惬	忄 匚 夹
濮	氵 亻 业 养字头
瘸	疒 力 口 肉
琶	王 王 巴
癖	疒 辟
祗	礻 氏 丶
邺	业 阝
杞	木 己
瞠	目 尚头 土
螂	虫 丶 即字旁 阝
烽	火 夂 丰
讹	讠 化
臆	月 音 心
蜒	虫 延字心 廴
沂	氵 斤
蜿	虫 宀 夕 㔾
蹂	足旁 矛 木
颍	匕 水 页
娠	女 辰
帚	彐 冖 巾
摒	扌 尸 丷 开
蟾	虫 尔字头 厂 八 言
遐	叚 辶
蜗	虫 呙
螭	虫 㐫 禸
淄	氵 巛 田
苞	艹 包
萼	艹 吅 亏
诠	讠 全字头 王
馅	饣 负字头 臼
谑	讠 虍 虐字底
氖	气 乃
唧	口 即字旁 卩
笆	竹头 巴
蚩	屮 一 虫
燎	火 大 丷 日 小
谥	讠 益字头 皿
掖	扌 亠 亻 夜下角
壑	歺头 谷 又 土
寰	宀 罒 同字心 衣省
馋	饣 免五 儿 冬字底
黔	黑 今
榄	木 览字头 见
竣	立 厶 八 夂
豢	龹 豕
蹋	足旁 日 羽
骁	马 尧字头 丆 乛
婵	女 丷 旦 丨
姗	女 册
玺	尔字头 小 玉
饬	饣 卧人 力
偃	亻 匚 日 女
唰	口 尸 巾 刂
鹉	一 弋 止 鸟
涎	氵 延字心 廴
呗	口 贝
麒	鹿旁 其
跷	足旁 尧字头 丆 乛
嗷	口 敖字旁 攵
丕	不 一
鼾	鼻 干
阖	门 去 皿
撅	扌 厂 䒑 䶹 欠
渍	氵 龶 贝
僭	亻 旡 旡 日
炖	火 屯
臧	臧字框 臣
噎	口 壳字头 豆
筱	竹头 修字旁 攵
缤	纟 宀 兵
烬	火 尺 冬字底
瑕	王 叚
卯	卯
簌	竹头 束 欠
酪	酉 各
漉	氵 鹿
戌	戊 一
汶	氵 文
轲	车旁 可
汛	氵 乛 十
峦	变字头 山
褶	衤 羽 白
铐	钅 耂 丂
晾	日 京
盅	中 皿
胭	月 囗 大
苯	艹 本
踵	足旁 𡈼 旦
恙	美字头 心
飒	立 风
镯	钅 罒 勹 虫
藕	艹 耒 日 禺字底
筏	竹头 亻 戈
萱	艹 宀 一 旦
奂	奂
芥	艹 介
叁	厶 大 三
憬	忄 景
媛	女 爫 一 友
碘	石 典字头 一 八
嗳	口 爱字头 友
彤	丹 彡
邙	亡 阝
兖	六 厶 儿
茗	艹 夕 口
酉	酉
沓	水 日
嗟	口 差字头 工
闾	门 吕
挝	扌 寸 辶
癞	疒 束 尔字头 贝
坯	土 不 一
伫	亻 宀 一
雒	各 隹
鹫	京 尤 鸟
荃	艹 全字头 王
锺	钅 𡈼 旦
挎	扌 大 亏
铿	钅 贤字头 土
飙	犬 犬 犬 风
蟋	虫 釆 心
谧	讠 心 丿 皿
亘	一 旦
猥	犭 田 一 畏字底
惆	忄 周字框 土 口
刽	全字头 云 刂
媲	女 囟 比
氟	气 弗
湍	氵 山 而
蔷	艹 丧字头 囗 口
璐	王 足旁 各
嗫	口 耳 双
稷	禾 田 八 夂
缄	纟 戊 同字心
垛	土 几 木
瘢	疒 舟 殳
蕙	艹 凬字心 虫无口 心
浒	氵 讠 卧人 十
甥	生 田 力
睑	目 亼 应字心
迳	经右角 工 辶
甬	龴 甬字底
逵	土 八 土 辶
祯	礻 卢字头 贝
鳖	㡀 攵 鱼
汞	工 水
恣	冫 欠 心
诰	讠 告字头 口
旌	旅字框 生
珑	王 龙
梆	木 寿字头 阝
喏	口 艹 左字框 口
捺	扌 大 示
斡	龺 全字头 斗
湮	氵 覀 土
胯	月 大 亏
蘸	艹 酉 隹 灬
螃	虫 立无横 冖 方
螅	虫 自 心
荔	艹 力 力 力
蚌	虫 丰
瀛	氵 赢字框 女
蟠	虫 釆 田
踊	足旁 龴 甬字底
痔	疒 土 寸
皿	皿
贰	弋 二 贝
隼	隹 十
芷	艹 止
荼	艹 全字头 余字底
傩	亻 又 隹
徵	微字框无一 一 王
泯	氵 民
蓟	艹 鱼 刂
簪	竹头 旡 旡 日
骰	骨 殳
脐	月 齐
飓	风 具字头 八
孺	子 雨头 而
佚	亻 丿 夫
羚	差字头 今 丶
辘	车旁 鹿
漕	氵 一 曲 日
腱	月 聿 廴
抠	扌 区
晁	日 儿 率字腰
桦	木 化 十
皋	白 大 十
髅	骨 娄
楔	木 丰 刀 大
谄	讠 负字头 臼
赡	贝 尔字头 厂 八 言
唷	口 充字头 青字底
寐	宀 爿 未
椰	木 耳 阝
蜻	虫 龶 青字底
嘭	口 壴 彡
疣	疒 尤
蟀	虫 亠 幺 率字腰 十
崆	山 穴 工
泵	石 水
篓	竹头 娄
蹒	足旁 艹 两
搪	扌 唐
玷	王 占
卞	亠 卜
噼	口 辟
鑫	金 金 金
镀	钅 度字框 又
琏	王 车 辶
娓	女 尸 毛
杳	木 日
犊	牜 卖字头 冬字底 大
昙	日 云
闰	门 王
篆	竹头 彑 豕省
踝	足旁 果
呷	口 甲
熹	壴 口 灬
缨	纟 贝 贝 女
蓓	艹 亻 咅
璞	王 业 养字头
坂	土 反字框 又
钾	钅 甲
鹞	爫 缶 鸟
剁	几 木 刂
谩	讠 日 罒 又
瞑	目 冖 日 六
佼	亻 交
噤	口 林 示
戾	户 犬
汕	氵 山
赓	广 聿三 人 贝
馍	饣 莫
嗥	口 白 大 十
煜	火 日 立
谙	讠 音
塾	享字头 子 丸 土
茉	艹 末
泗	氵 四
秸	禾 士 口
袂	衤 夬
贲	十 艹 贝
髻	镸 彡 士 口
湃	氵 龵 拜字边
迢	刀 口 辶
哞	口 厶 牛
淞	氵 木 公
潞	氵 足旁 各
煦	日 句 灬
婊	女 龶 衣省
耷	大 耳
拄	扌 主
掰	龵 分 手
涸	氵 囗 古
鳃	鱼 田 心
盂	一 于无横 皿
傣	亻 春字头 氺
虱	乛 丿 虫
羲	美字头 禾 丂 戈无一
喙	口 彑 豕省
欤	与 欠
麝	鹿 身 寸
徇	彳 勹 日
撸	扌 鱼 日
匝	匚 巾
痞	疒 不 口
咂	口 匚 巾
豺	豸 才
躏	足旁 艹 门 隹
锷	钅 吅 亏
夙	风省 歹
纣	纟 寸
喟	口 田 青字底
瞌	目 去 皿
窿	穴 阝 夂 一 生
诙	讠 左字框 火
荪	艹 子 小
匍	勹 甫
啬	丧字头 囗 口
坷	土 可
殡	歹 宀 兵
潺	氵 尸 子 子 子
岌	山 及
缮	纟 羊 䒑 口
澹	氵 尔字头 厂 八 言
蛰	执 虫
嗬	口 艹 亻 可
斛	角 斗
锏	钅 门 日
恫	忄 冂 同字心
蟆	虫 莫
町	田 丁
骠	马 覀 示
唏	口 乂 左字框 巾
绶	纟 爱字头 又
卅	卅
橹	木 鱼 日
钡	钅 贝
淇	氵 其
胱	月 光
螳	虫 尚头 土
皑	白 山 己
谀	讠 臼 人
鸯	见二 大 鸟
跻	足旁 齐
擞	扌 娄 攵
椿	木 春字头 日
嘤	口 贝 贝 女
篝	竹头 寒字腰 冉
厩	厂 即字旁 旡
嵇	禾 尤 山
腆	月 典字头 一 八
蛀	虫 主
邬	乌 阝
夔	䒑 自 止 巳 八 夂
恚	圭 心
辍	车旁 双 双
咻	口 亻 木
涓	氵 口 青字底
箓	竹头 录字头 氺
轶	车旁 丿 夫
跚	足旁 册
邃	穴 丷 豕 辶
嚏	口 索字头 田 疋
曜	日 羽 隹
珥	王 耳
瞰	目 乛 耳 攵
翱	白 大 十 羽
岱	亻 弋 山
臼	臼
眈	目 冖 儿
葆	艹 亻 口 木
扉	户 非
槌	木 追字心 辶
猓	犭 果
籁	竹头 束 尔字头 贝
苻	艹 亻 寸
谆	讠 享字头 子
箕	竹头 其
蔗	艹 度字框 灬
啾	口 禾 火
腼	月 面
荤	荧字头 车
剽	覀 示 刂
泾	氵 经右角 工
淖	氵 卢字头 早
酮	酉 冂 同字心
锢	钅 囗 古
雹	雨头 包
骧	马 衣框 吅 寒字腰
龛	合 龙
恿	龴 甬字底 心
獗	犭 厂 䒑 䶹 欠
裆	衤 尚字头 彐
鹳	艹 吅 隹 鸟
牒	片 廿 乛 木
樟	木 立 早
焙	火 咅
痣	疒 士 心
檬	木 荧字头 一 豕
疵	疒 此
熠	火 羽 白
睽	目 癶 天
泞	氵 宀 丁
蚯	虫 丘无横 一
蛹	虫 龴 甬字底
畹	田 宀 夕 㔾
淬	氵 亠 从 十
怆	忄 全字头 㔾
罹	罒 忄 隹
飕	风 臼 丨 又
浣	氵 宀 元
啐	口 亠 从 十
宸	宀 辰
桧	木 全字头 云
琥	王 虎
銮	变字头 金
鋆	土 勹 冫 金
沣	氵 丰
睐	目 来
翦	䒑 青字底 刂 羽
颚	吅 亏 页
沅	氵 元
镐	钅 高
娲	女 呙
庖	广 包
斓	文 门 束 丷
璜	王 黄
祛	礻 去
咫	尺 只
荟	艹 全字头 云
僮	亻 童
昵	日 尸 匕
皎	白 交
氦	气 亥
罔	冂 䒑 亡
闩	门 一
槟	木 宀 兵
溟	氵 冖 日 六
缥	纟 覀 示
楣	木 眉字框 目
蛔	虫 囗 口
靥	厂 犬 面
黜	黑 屮 凵
囔	口 囊字头 吅 寒字腰 衣省
骋	马 由 丂
忻	忄 斤
榈	木 门 吕
妍	女 开
橇	木 毛 毛 毛
瘠	疒 率字腰 人 青字底
阂	门 亥
灸	久二 丶 火
噫	口 音 心
杵	木 卧人 十
镁	钅 美字头 大
儡	亻 田 田 田
耘	耒 云
腌	月 大 电
觐	革 二 见
醮	酉 隹 灬
焊	火 日 干
醺	酉 千 黑
黠	黑 士 口
侗	亻 冂 同字心
椋	木 京
舀	爫 臼
窠	穴 果
裨	衤 卑
摞	扌 田 糸
瘴	疒 立 早
癣	疒 鱼 羊
耙	耒 巴
芍	艹 勹 丶
捱	扌 厂 圭
栾	变字头 木
榕	木 宀 谷
龈	齿 艮
擢	扌 羽 隹
痘	疒 豆
睢	目 隹
绾	纟 宀 㠯
鬃	镸 彡 宀 示
弈	亠 亦字底 廾
獠	犭 大 丷 日 小
蛆	虫 且
谗	讠 免五 儿 冬字底
铛	钅 尚字头 彐
倌	亻 宀 㠯
邝	广 阝
啷	口 丶 即字旁 阝
圪	土 卧人 乙
痫	疒 门 木
邕	巛 邑
酰	酉 先
晔	日 化 十
渥	氵 尸 至
佗	亻 宀 匕
睨	目 臼 儿
蜥	虫 木 斤
孛	索字头 子
郸	丷 旦 丨 阝
镌	钅 隹 乃
鳗	鱼 日 罒 又
冁	丷 旦 丨 尸 展字心
痢	疒 禾 刂
秆	禾 干
嚅	口 雨头 而
胄	由 青字底
郅	至 阝
瘀	疒 方 全字头 冬字底
蝌	虫 禾 斗
觊	山 己 见
蚪	虫 斗
暹	日 隹 辶
穑	禾 丧字头 囗 口
糯	米 雨头 而
锹	钅 禾 火
饴	饣 厶 口
哂	口 西
掸	扌 丷 旦 丨
蛐	虫 曲
岖	山 区
蜓	虫 壬 廴
疟	疒 虐字底
蹩	㡀 攵 足
莓	艹 卧人 母
胛	月 甲
谌	讠 其 乛
岬	山 甲
囤	囗 屯
嬷	女 麻 丿 厶
糠	米 广 隶字框 率字腰
汨	氵 日
洵	氵 勹 日
蚣	虫 公
酗	酉 凶
氪	气 古 儿
蜃	辰 虫
鳎	鱼 日 羽
孪	变字头 子
峪	山 谷
弑	乂 朩 弋 工
棣	木 隶字框 率字腰
疱	疒 包
舐	舌 氏
炀	火 乛 横两撇
箩	竹头 罒 夕
阚	门 乛 耳 攵
龇	齿 此
镂	钅 娄
咣	口 光
徨	彳 白 王
盹	目 屯
袤	衣框 矛
郢	口 王 阝
嗐	口 宀 丰 口
砥	石 氏 丶
荚	艹 夹
蚓	虫 弓 丨
偈	亻 曷
氐	氏 丶
咛	口 宀 丁
愠	忄 日 皿
鄱	釆 田 阝
怏	忄 见二 大
淙	氵 宀 示
琊	王 牙 阝
柠	木 宀 丁
涝	氵 荧字头 力
苓	艹 今 丶
馁	饣 爫 女
鹄	告字头 口 鸟
濑	氵 束 尔字头 贝
胫	月 经右角 工
芋	艹 一 于无横
璀	王 山 隹
隽	隹 乃
弋	弋
燮	言 火 火 又
泓	氵 弓 厶
窈	穴 幺 力
畿	幺 幺 戈 田
衢	行 目 目 隹
鹭	足旁 各 鸟
瑁	王 冒字头 目
碴	石 木 旦
筠	竹头 土 勹 冫
韭	非 一
涿	氵 豕 丶
龌	齿 尸 至
婀	女 阝 可
戛	丆 目 戈
臊	月 口 吅 木
宓	宀 心 丿
宕	宀 石
蟑	虫 立 早
豌	豆 宀 夕 㔾
骊	马 一 丽下角 丽下角
鲫	鱼 即字旁 卩
鲇	鱼 占
煊	火 宀 一 旦
罂	贝 贝 缶
娩	女 免五 儿
铬	钅 各
蒯	艹 月 月 刂
褴	衤 览字头 皿
谔	讠 吅 亏
骈	马 丷 开
洄	氵 囗 口
崂	山 荧字头 力
箴	竹头 戊 同字心
镣	钅 大 丷 日 小
妲	女 旦
檄	木 白 方 攵
沏	氵 七 刀
啵	口 氵 皮
汐	氵 夕
疽	疒 且
纫	纟 刀 丶
蒿	艹 高
鹗	吅 亏 鸟
俦	亻 寿字头 寸
殒	歹 员
魇	厂 犬 鬼
幺	幺
榭	木 身 寸
蓿	艹 宀 亻 百
圩	土 一 于无横
忑	下 心
琬	王 宀 夕 㔾
粼	米 舛 巜
绺	纟 夂 卜 口
诋	讠 氏 丶
迩	尔字头 小 辶
藓	艹 鱼 羊
靼	革 旦
俚	亻 里
殁	歹 殳
饕	口 丂 虎 食
仄	厂 人
牍	片 卖字头 冬字底 大
蠡	彑 豕省 虫 虫
诳	讠 犭 王
懋	木 矛 木 心
掬	扌 勹 米
熵	火 立无横 𠕉字底 口
霭	雨头 讠 曷
濂	氵 广 䒑 聿三 兼无䒑无彐
锰	钅 子 皿
婕	女 一 聿三 龰
袈	力 口 衣
镭	钅 雨头 田
皙	木 斤 白
咝	口 丝左角 丝左角 一
斫	石 斤
褛	衤 娄
臃	月 亠 乡 隹
匐	勹 同字心 田
埂	土 更
娑	氵 少 女
柑	木 甘
榷	木 冖 隹
歆	音 欠
噙	口 全字头 㐫 禸
犒	牜 高
馐	饣 差字头 录字头 丨
孢	子 包
蓑	艹 衣框 口 一
郦	一 丽下角 丽下角 阝
霾	雨头 豸 里
叵	匚 口
氲	气 日 皿
鲲	鱼 日 比
鸵	鸟 宀 匕
祚	礻 乍
鹑	享字头 子 鸟
啮	口 齿
岷	山 民
滦	氵 变字头 木
纭	纟 云
恸	忄 云 力
艮	艮
娉	女 由 丂
扪	扌 门
诿	讠 禾 女
滂	氵 立无横 冖 方
讫	讠 卧人 乙
弁	厶 廾
砧	石 占
蛭	虫 至
谡	讠 田 八 夂
莘	艹 辛
啻	立无横 冖 巾 口
舫	舟 方
荨	艹 彐 寸
俑	亻 龴 甬字底
冽	冫 歹 刂
椽	木 彑 豕省
辇	夫 夫 车
雉	矢 隹
泸	氵 卢字头 尸
钛	钅 太
榔	木 丶 即字旁 阝
蕨	艹 厂 䒑 䶹 欠
诒	讠 厶 口
覃	覀 早
揆	扌 癶 天
蟮	虫 羊 䒑 口
烯	火 乂 左字框 巾
獾	犭 艹 吅 隹
翊	立 羽
姣	女 交
憩	舌 自 心
摈	扌 宀 兵
缙	纟 亚 日
鲈	鱼 卢字头 尸
嘹	口 大 丷 日 小
孀	女 雨头 相
钚	钅 不
洌	氵 歹 刂
纾	纟 予
饨	饣 屯
剐	呙 刂
浜	氵 兵
瘁	疒 亠 从 十
怵	忄 木 丶
烷	火 宀 元
祐	礻 左字框 口
缇	纟 是
隍	阝 白 王
嶙	山 米 舛
粲	歺 又 米
沱	氵 宀 匕
篙	竹头 高
挞	扌 大 辶
摁	扌 囗 大 心
猕	犭 弓 尔字头 小
赊	贝 全字头 示
蹶	足旁 厂 䒑 䶹 欠
涮	氵 尸 巾 刂
铡	钅 贝 刂
噘	口 厂 䒑 䶹 欠
刍	刍
牦	牜 毛
狻	犭 厶 八 夂
鲑	鱼 圭
鹂	一 丽下角 丽下角 鸟
耄	老 毛
遛	留字头 田 辶
垠	土 艮
蝮	虫 卧人 日 夂
坳	土 幺 力
妫	女 丶 力 丶
樽	木 酋 寸
茁	艹 屮 凵
呓	口 艹 乙
奁	大 区
懔	忄 亠 囗 口 示
箔	竹头 氵 白
钜	钅 匸 叚右角
濡	氵 雨头 而
莒	艹 吕
阡	阝 千
佞	亻 二 女
慵	忄 广 肀 甬字底
犄	牜 大 可
蚱	虫 乍
谘	讠 冫 欠 口
铤	钅 壬 廴
颧	艹 吅 隹 页
熨	尸 示 寸 火
纨	纟 丸
剜	宀 夕 㔾 刂
殓	歹 亼 应字心
槁	木 高
邂	角 刀 牛 辶
骛	矛 攵 马
唑	口 从 土
庑	广 无
瞭	目 大 丷 日 小
诤	讠 尔字头 争字底
辏	车旁 春字头 天
犟	弓 口 虫 牛
猬	犭 田 青字底
祉	礻 止
夯	大 力
妪	女 区
胪	月 卢字头 尸
钰	钅 玉
馕	饣 囊字头 吅 寒字腰 衣省
恁	亻 壬 心
荩	艹 尺 冬字底
仨	亻 三
僖	亻 壴 口
榘	矢 匸 叚右角 木
罄	士 眉字框 殳 缶
谝	讠 户 扁字心
闱	门 韦
靓	龶 青字底 见
榛	木 春字头 禾
簦	竹头 癶 豆
宥	宀 左字框 青字底
潢	氵 黄
饯	饣 戋
涔	氵 山 今
寮	宀 大 丷 日 小
忤	忄 卧人 十
泅	氵 囗 人
隗	阝 鬼
墉	土 广 肀 甬字底
胴	月 冂 同字心
蝈	虫 囗 玉
砷	石 日 丨
珞	王 各
鳅	鱼 禾 火
獭	犭 束 尔字头 贝
荥	荧字头 水
觥	角 光
鏖	鹿 金
倜	亻 周字框 土 口
嘁	口 戊 上 小
掇	扌 双 双
柚	木 由
氤	气 囗 大
淅	氵 木 斤
菠	落字框 皮
蛳	虫 师字旁 一 巾
酚	酉 分
峒	山 冂 同字心
涞	氵 来
繇	爫 缶 丿 糸
俅	亻 求
嗑	口 去 皿
烨	火 化 十
燔	火 釆 田
邋	巛 巤字底 辶
咿	口 亻 尹
旖	旅字框 大 可
镍	钅 自 木
霁	雨头 齐
椤	木 罒 夕
蚜	虫 牙
辔	纟 车 纟 口
鼐	乃 目 鼎字框
咤	口 宀 丿 七
峋	山 勹 日
拮	扌 士 口
踮	足旁 广 占
酯	酉 匕 日
壹	壳字头 豆
庋	广 支
癜	疒 尸 共 殳
饽	饣 索字头 子
搽	扌 艹 全字头 朩
蛎	虫 厂 万
迨	厶 口 辶
偻	亻 娄
槊	䒑 䶹 月 木
谶	讠 从 戈 非 一
赳	走 丩
龊	齿 足
啕	口 勹 缶
嗵	口 龴 甬字底 辶
墒	土 立无横 𠕉字底 口
媾	女 寒字腰 冉
恽	忄 冖 车
琰	王 火 火
铣	钅 先
馄	饣 日 比
嗝	口 鬲
飚	风 火 火 火
醯	酉 㐬 皿
儆	亻 艹 句 攵
哐	口 匚 王
遑	白 王 辶
魑	鬼 㐫 禸
嗲	口 父 夕 夕
笞	竹头 厶 口
苌	艹 长
氰	气 龶 青字底
橐	囊字头 石 木
馊	饣 臼 丨 又
妤	女 予
燧	火 丷 豕 辶
莅	艹 亻 立
缈	纟 目 少
邈	豸 白 儿 辶
伲	亻 尸 匕
庠	广 羊
懑	氵 艹 两 心
闼	门 大 辶
噔	口 癶 豆
抟	扌 专
杈	木 又 丶
荻	艹 犭 火
逅	后字框 口 辶
矾	石 凡
馑	饣 革 二
馥	禾 日 卧人 日 夂
劭	刀 口 力
呶	口 女 又
昕	日 斤
昱	日 立
栎	木 乐二 小
蔫	艹 正 与无横 灬
镕	钅 宀 谷
庾	广 臼 人
柩	木 匚 久二 丶
殇	歹 卧人 乛 横两撇
汜	氵 巳
迤	卧人 也 辶
囿	囗 左字框 青字底
忝	天 恭字底
鳝	鱼 羊 䒑 口
苷	艹 甘
衮	衣框 公
镳	钅 鹿 灬
颦	止 步字底 页 卑
飧	夕 食
忸	忄 录字头 丨
腴	月 臼 人
蠹	囊字头 石 虫 虫
琨	王 日 比
觎	亼 青字底 刂 见
谯	讠 隹 灬
囫	囗 勹 横两撇
笏	竹头 勹 横两撇
鞯	革 艹 在字框 子
飨	乡 食
凇	冫 木 公
淼	水 水 水
爻	乂 乂
蜚	非 虫
郏	夹 阝
饪	饣 壬
鋈	氵 夭 金
蔺	艹 门 隹
觯	角 丷 旦 丨
诜	讠 先
铳	钅 充字头 儿
鸢	弋 鸟
呲	口 此
湎	氵 面
麋	鹿 米
竦	立 束
奘	爿 士 大
粑	米 巴
缫	纟 巛 果
肽	月 太
膘	月 覀 示
臾	臼 人
芪	艹 氏
苫	艹 占
荭	艹 纟 工
阗	门 直 八
俪	亻 一 丽下角 丽下角
滓	氵 宀 辛
蜇	扌 斤 虫
趔	走 歹 刂
嘣	口 山 月 月
呦	口 幺 力
栉	木 艹 节字底
菟	艹 兔
藜	艹 禾 黎右角 全字头 氺
佘	全字头 示
濠	氵 亮字头 豕
稹	禾 直 八
佝	亻 句
孱	尸 子 子 子
枸	木 句
疸	疒 旦
膑	月 宀 兵
虻	虫 亡
濯	氵 羽 隹
箝	竹头 扌 甘
蝼	虫 娄
铩	钅 乂 朩
霏	雨头 非
乩	占 乛
赝	厂 亻 隹 贝
盥	臼裂 水 皿
祜	礻 古
谖	讠 爫 一 友
锨	钅 斤 欠
霰	雨头 龷 青字底 攵
徭	彳 爫 缶
肓	亡 青字底
蛉	虫 今 丶
倨	亻 居
硼	石 月 月
趺	足旁 夫
鱿	鱼 尤
埽	土 彐 冖 巾
娣	女 丷 弓 弟省无弓
楹	木 乃 又 皿
洹	氵 一 旦
绉	纟 刍
虢	爫 寸 虎
詈	罒 言
诨	讠 冖 车
锲	钅 丰 刀 大
铰	钅 交
泱	氵 见二 大
绻	纟 龹 㔾
巽	巳 巳 共
晟	日 成三 戈无一
桎	木 至
淦	氵 金
芩	艹 今
锃	钅 口 王
呤	口 今 丶
戡	其 乛 戈
浔	氵 彐 寸
澧	氵 曲 豆
羿	羽 廾
酆	山 丰 丰 豆 阝
蜴	虫 日 勹 横两撇
渚	氵 者
诮	讠 尚字头 青字底
郧	员 阝
崴	山 戊 一 女
犷	犭 广
砺	石 厂 万
纥	纟 卧人 乙
魃	鬼 友 丶
摺	扌 羽 白
讣	讠 卜
谪	讠 立无横 冂 古
颀	斤 页
垩	亚 土
岫	山 由
搡	扌 又 双 木
绦	纟 夂 朩
馗	九 首
璨	王 歺 又 米
遨	敖字旁 攵 辶
铂	钅 白
眦	目 此
卟	口 卜
泷	氵 龙
纰	纟 比
蹴	足旁 京 尤
轱	车旁 古
铨	钅 全字头 王
锟	钅 日 比
髭	镸 彡 此
姘	女 丷 开
榉	木 兴 举字底
粽	米 宀 示
赭	土 亦字底 者
罅	缶 虍 乊 于无横
陂	阝 皮
伉	亻 亠 几
姹	女 宀 丿 七
诟	讠 后字框 口
龅	齿 包
撷	扌 士 口 页
瘙	疒 又 丶 虫
鸬	卢字头 尸 鸟
秣	禾 末
笥	竹头 乛 同字心
翳	匚 矢 殳 羽
螨	虫 艹 两
诓	讠 匚 王
晗	日 今 口
碣	石 曷
箸	竹头 者
翕	合 羽
鹌	大 电 鸟
痿	疒 禾 女
赧	土 亦字底 报字边无又 又
咭	口 士 口
汩	氵 曰
砭	石 丿 之
舛	舛
襁	衤 弓 口 虫
诌	讠 刍
跸	足旁 比 十
蹇	寒字头 足
怼	又 寸 心
涪	氵 咅
薨	艹 罒 冖 歹 匕
鲱	鱼 非
愎	忄 卧人 日 夂
揄	扌 亼 青字底 刂
窕	穴 儿 率字腰
羯	差字头 曷
醴	酉 曲 豆
梏	木 告字头 口
煨	火 田 一 畏字底
粕	米 白
茯	艹 亻 犬
鍪	矛 攵 金
钍	钅 土
锉	钅 从 土
鹘	骨 鸟
戕	爿 戈
聒	耳 舌
誊	龹 言
陲	阝 垂
髡	镸 彡 丆 乛
郓	冖 车旁 阝
鄢	正 与无横 灬 阝
闳	门 左字框 厶
阕	门 癶 天
湟	氵 白 王
畦	田 圭
竑	立 左字框 厶
肱	月 左字框 厶
咩	口 羊
碜	石 厶 大 彡
艄	舟 尚字头 青字底
艿	艹 乃
衩	衤 又 丶
钨	钅 乌
鲟	鱼 彐 寸
吒	口 丿 七
噌	口 丷 曾字头无丷 日
峥	山 尔字头 争字底
徜	彳 尚
鸨	匕 十 鸟
刈	乂 刂
珏	王 玉
逡	厶 八 夂 辶
媪	女 日 皿
玮	王 韦
臬	自 木
褡	衤 艹 合
酢	酉 乍
阈	门 戈 口 一
麂	鹿 几
夤	夕 宀 一 由 八
孳	䒑 幺 幺 子
钹	钅 友 丶
馏	饣 留字头 田
鸷	执 鸟
哙	口 全字头 云
幄	巾 尸 至
潍	氵 纟 隹
矍	目 目 隹 又
裱	衤 龶 衣省
讴	讠 区
砒	石 比
呔	口 太
薏	艹 音 心
谲	讠 矛 𠕉字底 口
驷	马 四
喑	口 音
芊	艹 千
苁	艹 从
闿	门 山 己
俎	人 人 且
阏	门 方 全字头 冬字底
骞	寒字头 马
猷	酋 犬
痨	疒 荧字头 力
肄	匕 矢 聿
芨	艹 及
弭	弓 耳
歙	合 羽 欠
氅	尚 攵 毛
煲	亻 口 木 火
爰	爫 一 友
璎	王 贝 贝 女
篾	竹头 罒 戊 丶
铉	钅 亠 幺
厝	厂 龷 日
楫	木 口 耳
牝	牜 匕
稗	禾 卑
衾	今 衣
豕	豕
钴	钅 古
徕	彳 来
掴	扌 囗 玉
桠	木 亚
烩	火 全字头 云
骅	马 化 十
啖	口 火 火
峁	山 卯
怩	忄 尸 匕
樾	木 走 戉
赍	索字头 从 贝
圻	土 斤
嵘	山 荧字头 木
揿	扌 钅 欠
楂	木 木 旦
碛	石 龶 贝
茏	艹 龙
裟	氵 少 衣
趄	走 且
馔	饣 巳 巳 共
鹬	矛 𠕉字底 口 鸟
囡	囗 女
嗪	口 春字头 禾
殚	歹 丷 旦 丨
潸	氵 林 青字底
甑	丷 曾字头无丷 日 瓦
逖	犭 火 辶
錾	车旁 斤 金
孬	不 女 子
痤	疒 从 土
逋	甫 辶
佥	亼 应字心
炜	火 韦
傥	亻 尚头 儿
苣	艹 匸 叚右角
阄	门 龟
嵬	山 鬼
嶂	山 立 早
揶	扌 耳 阝
昶	丶 永无点 日
杲	日 木
滟	氵 丰 尔字头 巴
瓯	区 瓦
砣	石 宀 匕
绌	纟 屮 凵
胝	月 氏 丶
莆	艹 甫
酊	酉 丁
抻	扌 日 丨
渌	氵 录字头 氺
鬣	镸 彡 巛 巤字底
唁	口 言
媸	女 屮 一 虫
帼	巾 囗 玉
蠼	虫 目 目 隹 又
铱	钅 衣
湫	氵 禾 火
黍	禾 全字头 氺
踅	扌 斤 足
遴	米 舛 辶
颏	亥 页
魍	鬼 冂 䒑 亡
鸩	冖 儿 鸟
鼹	鼠 日 宀 女
勖	冒字头 目 力
洱	氵 耳
粳	米 更
舢	舟 山
薮	艹 娄 攵
鎏	氵 㐬 金
镏	钅 留字头 田
沤	氵 区
猗	犭 大 可
骓	马 隹
啶	口 定
嬗	女 亠 囗 口 旦
恂	忄 勹 日
悌	忄 丷 弓 弟省无弓
獐	犭 立 早
砝	石 去
竽	竹头 一 于无横
羸	赢字框 羊
苋	艹 见
蚝	虫 毛
鄯	羊 䒑 口 阝
醛	酉 艹 全字头 王
闶	门 亠 几
颢	景 页
鲛	鱼 交
掼	扌 毌 贝
棂	木 彐 火
琮	王 宀 示
缢	纟 益字头 皿
掾	扌 彑 豕省
珈	王 力 口
痂	疒 力 口
硎	石 开 刂
耦	耒 日 禺字底
耨	耒 辰 寸
螫	土 亦字底 攵 虫
觞	角 卧人 乛 横两撇
酩	酉 夕 口
骶	骨 氏 丶
淝	氵 月 巴
钺	钅 戉
峤	山 夭 乔字底
硒	石 西
舸	舟 可
橛	木 厂 䒑 䶹 欠
疥	疒 介
脍	月 全字头 云
蚨	虫 夫
蜊	虫 禾 刂
螟	虫 冖 日 六
轭	车旁 厂 㔾
嗄	口 丆 目 夂
榫	木 隹 十
炔	火 夬
痈	疒 用
笤	竹头 刀 口
噱	口 虍 豕
壅	亠 乡 隹 土
猊	犭 臼 儿
笕	竹头 见
讵	讠 匸 叚右角
俣	亻 口 天
槿	木 革 二
毂	壳字头 车旁 殳
礴	石 落字框 甫 寸
荞	艹 夭 乔字底
钤	钅 今
阆	门 丶 艮
矸	石 干
锂	钅 里
阋	门 臼 儿
龃	齿 且
掮	扌 户 青字底
穰	禾 衣框 吅 寒字腰
苡	艹 以字旁 人
菏	落字框 可
涫	氵 宀 㠯
磬	士 眉字框 殳 石
绡	纟 尚字头 青字底
轸	车旁 全字头 彡
焓	火 今 口
蓖	艹 囟 比
鲧	鱼 丿 糸
浃	氵 夹
玖	王 久二 丶
瓤	衣框 吅 寒字腰 瓜
苜	艹 目
蒺	艹 疒 矢
謇	寒字头 言
钏	钅 川
鹜	矛 攵 鸟
齑	齐 非 一
杼	木 予
舂	春字头 臼
鲂	鱼 方
乜	乛 乛
烃	火 经右角 工
莜	艹 修字旁 攵
圜	囗 罒 同字心 衣省
恹	忄 厂 犬
玳	王 亻 弋
笫	竹头 姊字边
缗	纟 民 日
葭	艹 叚
仃	亻 丁
氩	气 亚
蟪	虫 凬字心 虫无口 心
逶	禾 女 辶
锴	钅 比 白
龉	齿 五 口
俳	亻 非
匦	匚 车旁 九
啭	口 车旁 专
愆	行 氵 心
畲	全字头 示 田
窣	穴 亠 从 十
姝	女 丿 未
屐	尸 彳 支
瑭	王 唐
稔	禾 今 心
笮	竹头 乍
葺	艹 口 耳
岢	山 可
崧	山 木 公
挈	丰 刀 手
潆	氵 荧字头 糸
焱	火 火 火
菀	艹 宀 夕 㔾
赜	颐字旁 龶 贝
郯	火 火 阝
姒	女 以字旁 人
槭	木 戊 上 小
靛	龶 青字底 定
烊	火 羊
箐	竹头 龶 青字底
魉	鬼 两
帑	女 又 巾
泠	氵 今 丶
牯	牜 古
茑	艹 鸟
蛴	虫 齐
衽	衤 壬
褓	衤 亻 口 木
诖	讠 圭
殛	歹 了 口 又 一
芾	艹 丙三 丨
诂	讠 古
诹	讠 耳 又
毖	比 心 丿
炷	火 主
蛩	工 凡 虫
谠	讠 尚头 儿
刎	勹 横两撇 刂
忾	忄 气
戬	亚 日 戈
曷	曷
柞	木 乍
樯	木 丧字头 囗 口
碇	石 定
蚴	虫 幺 力
郛	爫 子 阝
颛	山 而 页
妗	女 今
窸	穴 釆 心
饧	饣 乛 横两撇
唳	口 户 犬
溴	氵 自 犬
菖	艹 日 日
镉	钅 鬲
鹧	度字框 灬 鸟
吡	口 比
婺	矛 攵 女
岘	山 见
崮	山 囗 古
枰	木 平
灏	氵 景 页
磔	石 舛 木
缂	纟 革
蛞	虫 舌
蠖	虫 艹 隹 又
醚	酉 米 辶
饔	亠 乡 隹 食
鸪	古 鸟
旎	旅字框 尸 匕
氚	气 川
睥	目 卑
蛄	虫 古
邳	不 一 阝
阒	门 目 犬
鬈	镸 彡 龹 㔾
凫	鸟省 几
旮	九 日
犍	牜 聿 廴
缟	纟 高
蘅	艹 行 衡字心
蠲	益字头 皿 罒 勹 虫
鞣	革 矛 木
焖	火 门 心
缦	纟 日 罒 又
鲆	鱼 平
灞	氵 雨头 革 月
缁	纟 巛 田
趿	足旁 及
踽	足旁 丿 口 禺字底
遢	日 羽 辶
钿	钅 田
颞	耳 双 页
鲶	鱼 今 心
鼋	元 黾
愍	民 攵 心
槎	木 差字头 工
狎	犭 甲
缛	纟 辰 寸
娌	女 里
膻	月 亠 囗 口 旦
茱	艹 丿 未
遒	酋 辶
郴	林 阝
镢	钅 厂 䒑 䶹 欠
镫	钅 癶 豆
髋	骨 宀 艹 见
佻	亻 儿 率字腰
枋	木 方
浠	氵 乂 左字框 巾
瘛	疒 丰 刀 心
碚	石 咅
禳	礻 衣框 吅 寒字腰
羟	差字头 经右角 工
臁	月 广 䒑 聿三 兼无䒑无彐
苕	艹 刀 口
虼	虫 卧人 乙
蹼	足旁 业 养字头
醪	酉 羽 全字头 彡
骜	敖字旁 攵 马
黩	黑 卖字头 冬字底 大
劬	句 力
挲	氵 少 手
莠	艹 禾 乃
鄣	立 早 阝
餍	厂 犬 食
芗	艹 乡
葩	艹 白 巴
娆	女 尧字头 丆 乛
洙	氵 丿 未
祇	礻 氏
绀	纟 甘
芎	艹 弓
讦	讠 干
铵	钅 宀 女
髁	骨 果
鲎	学无子 鱼
鲢	鱼 车 辶
哔	口 比 十
纡	纟 一 于无横
胍	月 瓜
勐	子 皿 力
嫠	未 攵 厂 女
笳	竹头 力 口
糁	米 厶 大 彡
芫	艹 元
阍	门 氏 日
墀	土 尸 犀字心头 牛
帏	巾 韦
廪	广 亠 囗 口 示
擀	扌 龺 全字头 干
狷	犭 口 青字底
蟊	矛 虫 虫
跏	足旁 力 口
鬻	弓 米 弓 鬲
鳏	鱼 罒 鳏下角
鳕	鱼 雨头 彐
佰	亻 百
厣	厂 犬 甲
嫱	女 丧字头 囗 口
彀	壳字头 一 弓 殳
韪	是 韦
屙	尸 阝 可
睇	目 丷 弓 弟省无弓
芏	艹 土
蠓	虫 荧字头 一 豕
郗	乂 左字框 巾 阝
嘧	口 宀 心 丿 山
坨	土 宀 匕
垭	土 亚
聩	耳 贵字头 贝
裰	衤 双 双
钒	钅 凡
铆	钅 卯
饫	饣 夭
鹚	䒑 幺 幺 鸟
龆	齿 刀 口
仞	亻 刀 丶
桁	木 行
洮	氵 儿 率字腰
濉	氵 目 隹
缬	纟 士 口 页
芄	艹 丸
菸	艹 方 全字头 冬字底
藿	艹 雨头 隹
褫	衤 反字框 虎
鏊	敖字旁 攵 金
饩	饣 气
仟	亻 千
侩	亻 全字头 云
嘞	口 革 力
眇	目 少
绔	纟 大 亏
腚	月 定
菅	艹 宀 㠯
萸	艹 臼 人
踔	足旁 卢字头 早
妯	女 由
蚧	虫 介
勰	力 力 力 田 心
囟	囟
垅	土 龙
怄	忄 区
杷	木 巴
枇	木 比
溧	氵 覀 木
澶	氵 亠 囗 口 旦
矽	石 夕
绱	纟 尚
莴	艹 呙
诔	讠 耒
锒	钅 丶 艮
镒	钅 益字头 皿
鞫	革 勹 言
嘌	口 覀 示
擤	扌 鼻
篑	竹头 贵字头 贝
嵊	山 禾框 北
枳	木 只
珩	王 行
痼	疒 囗 古
笾	竹头 力 辶
袢	衤 半
逄	夂 㐄 辶
鸹	舌 鸟
呋	口 夫
幂	冖 日 大 巾
撺	扌 穴 口 中
樗	木 雨头 亏
煅	火 段字旁 殳
瞽	壴 支 目
砉	丰 石
縻	麻 糸
芡	艹 欠
蚋	虫 内
蜍	虫 全字头 余字底
讧	讠 工
贽	执 贝
跆	足旁 厶 口
锶	钅 田 心
黾	黾
亳	亮字头 丿 七
囵	囗 仑
怫	忄 弗
桉	木 宀 女
祢	礻 尔字头 小
阌	门 爱字头 又
虺	丆 乛 虫
傈	亻 覀 木
卮	后字框 㔾
囹	囗 今 丶
忪	忄 公
旯	日 九
朐	月 句
滁	氵 阝 全字头 余字底
笪	竹头 旦
簟	竹头 覀 早
肼	月 井
腭	月 吅 亏
蜉	虫 爫 子
衿	衤 今
魈	鬼 尚字头 青字底
侔	亻 厶 牛
堀	土 尸 屮 凵
睚	目 厂 圭
箧	竹头 匚 夹
荛	艹 尧字头 丆 乛
裢	衤 车 辶
貉	豸 各
趸	万 足
镊	钅 耳 双
闫	门 三
侪	亻 齐
悒	忄 邑
汊	氵 又 丶
泫	氵 亠 幺
笸	竹头 匚 口
雎	且 隹
鳟	鱼 酋 寸
榧	木 匚 非
獒	敖字旁 攵 犬
跎	足旁 宀 匕
阃	门 囗 木
黢	黑 厶 八 夂
佤	亻 瓦
喁	口 日 禺字底
嗍	口 䒑 䶹 月
庥	广 亻 木
枥	木 厂 力
渑	氵 黾
牖	片 户 甫
眙	目 厶 口
筮	竹头 工 从
缶	缶
餮	歹 全字头 彡 食
嗉	口 龶 糸
堋	土 月 月
夥	果 夕 夕
峄	山 又 举字底
拊	扌 亻 寸
昀	日 勹 冫
浯	氵 五 口
糅	米 矛 木
綦	其 糸
罴	罒 去 灬
镛	钅 广 肀 甬字底
馓	饣 龷 青字底 攵
驽	女 又 马
倬	亻 卢字头 早
唿	口 勹 横两撇 心
柘	木 石
瘅	疒 丷 旦 丨
蜢	虫 子 皿
螈	虫 原
冼	冫 先
嘏	古 叚
堇	革 二
岿	山 师字旁 彐
柢	木 氏 丶
栀	木 后字框 㔾
氘	气 乔字底
渫	氵 廿 乛 木
硌	石 各
箅	竹头 田 丌
翀	羽 中
腈	月 龶 青字底
苎	艹 宀 一
茴	艹 囗 口
蟛	虫 壴 彡
鲐	鱼 厶 口
鸱	氏 丶 鸟
咴	口 左字框 火
啫	口 者
寤	宀 爿 五 口
搿	龵 合 手
毽	毛 聿 廴
泮	氵 半
秕	禾 比
蚍	虫 比
袷	衤 合
裾	衤 居
跬	足旁 圭
醢	酉 左字框 口 皿
倥	亻 穴 工
珐	王 去
瓞	瓜 丿 夫
碓	石 隹
笊	竹头 爪
舻	舟 卢字头 尸
跞	足旁 乐二 小
跹	足旁 千 辶
髂	骨 宀 各
鹕	古 月 鸟
旃	旅字框 丹
楮	木 者
矬	矢 从 土
砩	石 弗
膈	月 鬲
艏	舟 首
苴	艹 且
荏	艹 亻 壬
螯	敖字旁 攵 虫
郃	合 阝
铄	钅 乐二 小
圮	土 己
帙	巾 丿 夫
旆	旅字框 丙三 丨
桡	木 尧字头 丆 乛
溆	氵 全字头 余字底 又
潴	氵 犭 者
瘘	疒 娄
缒	纟 追字心 辶
芰	艹 支
诎	讠 屮 凵
锑	钅 丷 弓 弟省无弓
啁	口 周字框 土 口
椴	木 段字旁 殳
苄	艹 亠 卜
陟	阝 止 步字底
刖	月 刂
悭	忄 贤字头 土
熘	火 留字头 田
疝	疒 山
莸	艹 犭 尤
锕	钅 阝 可
雠	隹 讠 隹
鹩	大 丷 日 小 鸟
嗾	口 旅字框 矢
稞	禾 果
蛱	虫 夹
赅	贝 亥
鲋	鱼 亻 寸
匏	大 亏 包
崤	山 乂 左字框 青字底
怙	忄 古
砀	石 乛 横两撇
蠊	虫 广 䒑 聿三 兼无䒑无彐
裣	衤 亼 应字心
鹆	谷 鸟
鼬	鼠 由
嗌	口 益字头 皿
炝	火 全字头 㔾
疖	疒 节字底
硷	石 亼 应字心
籴	入 米
芟	艹 殳
僳	亻 覀 米
崃	山 来
崾	山 覀 女
愀	忄 禾 火
沆	氵 亠 几
痍	疒 大框 弓
硪	石 我
苤	艹 不 一
蔻	艹 宀 元 攴
薜	艹 辟
蜮	虫 戈 口 一
跗	足旁 亻 寸
蹉	足旁 差字头 工
韫	韦 日 皿
鳊	鱼 户 扁字心
卣	卢字头 囗 叚右角
浞	氵 足
猢	犭 古 月
獯	犭 千 黑
瘿	疒 贝 贝 女
艉	舟 尸 毛
訇	勹 言
踯	足旁 关 阝
醍	酉 是
雱	雨头 方
僦	亻 京 尤
嫒	女 爱字头 友
畛	田 全字头 彡
硐	石 冂 同字心
缯	纟 丷 曾字头无丷 日
胨	月 东二 小
鄄	覀 土 阝
锸	钅 千 臼
乇	丿 七
佶	亻 士 口
噻	口 寒字头 土
埙	土 员
婧	女 龶 青字底
嬖	辟 女
尕	乃 小
嵴	山 率字腰 人 青字底
徉	彳 羊
怛	忄 旦
槲	木 角 斗
涑	氵 束
獬	犭 角 刀 牛
缃	纟 相
脲	月 尸 水
谰	讠 门 束 丷
鞴	革 龷 丿 甬字底
鼍	吅 田 一 黾
粜	屮 凵 米
铧	钅 化 十
晷	日 夂 卜 口
狯	犭 全字头 云
狲	犭 子 小
畈	田 反字框 又
笱	竹头 句
逦	一 丽下角 丽下角 辶
钪	钅 亠 几
凼	水 凵
圄	囗 五 口
榇	木 亲
焐	火 五 口
珲	王 冖 车
肫	月 屯
膂	旅字框 旅下角 青字底
锛	钅 大 十 廾
鲅	鱼 友 丶
伧	亻 全字头 㔾
劢	万 力
昴	日 卯
猱	犭 矛 木
癯	疒 目 目 隹
盱	目 一 于无横
觳	壳字头 一 角 殳
鲮	鱼 土 八 夂
宄	宀 九
椁	木 享字头 子
笄	竹头 开
伥	亻 长
厍	厂 车
塬	土 原
挹	扌 邑
砻	龙 石
荠	艹 齐
菽	艹 上 小 又
蛘	虫 羊
轳	车旁 卢字头 尸
鹨	羽 全字头 彡 鸟
亓	一 丌
倮	亻 果
儋	亻 尔字头 厂 八 言
捌	扌 另 刂
氡	气 夂 冬字底
胗	月 全字头 彡
钼	钅 目
锆	钅 告字头 口
鹁	索字头 子 鸟
嚯	口 雨头 隹
郾	匚 日 女 阝
铖	钅 成三 戈无一
鞒	革 夭 乔字底
鲠	鱼 更
焯	火 卢字头 早
锗	钅 者
陉	阝 经右角 工
隳	阝 左字框 工 青字底 全字头 恭字底
兕	凹无横 丆 乛
嘬	口 日 耳 又
垓	土 亥
杓	木 勹 丶
枵	木 口 丂
檩	木 亠 囗 口 示
熳	火 日 罒 又
畚	厶 大 田
盍	去 皿
硗	石 尧字头 丆 乛
肟	月 亏
虿	万 虫
裥	衤 门 日
邨	屯 阝
鬯	鬯字头无凵 凵 匕
鲰	鱼 耳 又
黼	业 㡀 甫
狍	犭 包
瓠	大 亏 瓜
赀	此 贝
跣	足旁 先
龀	齿 化字边
澍	氵 壴 寸
碡	石 龶 母
缱	纟 贵字头 㠯 辶
蛑	虫 厶 牛
诶	讠 厶 矢
锩	钅 龹 㔾
镧	钅 门 束 丷
馃	饣 果
鬟	镸 彡 罒 同字心 衣省
孑	了 一
嵯	山 差字头 工
篪	竹头 反字框 虎
绲	纟 日 比
罘	罒 不
耪	耒 立无横 冖 方
聃	耳 冉
茔	荧字头 土
谇	讠 亠 从 十
蹚	足旁 尚头 土
鸫	东二 小 鸟
呖	口 厂 力
慊	忄 䒑 聿三 兼无䒑无彐
戆	立 早 夂 工 贝 心
炅	日 火
胼	月 丷 开
菔	艹 月 报字边无又 又
菹	落字框 且
镞	钅 旅字框 矢
唢	口 尚字头 贝
砗	石 车
莼	艹 纟 屯
萋	艹 妻字头 女
辚	车旁 米 舛
鼙	壴 支 卑
傧	亻 宀 兵
戗	全字头 㔾 戈
扦	扌 千
摭	扌 度字框 灬
楸	木 禾 火
洳	氵 女 口
萘	艹 大 示
蘩	艹 卧人 母 攵 糸
赉	来 贝
躅	足旁 罒 勹 虫
铍	钅 皮
鲀	鱼 屯
嶝	山 癶 豆
羰	差字头 山 左字框 火
胂	月 日 丨
蘖	艹 追字心 辛 木
诼	讠 豕 丶
钕	钅 女
鲡	鱼 一 丽下角 丽下角
堞	土 廿 乛 木
啉	口 林
楝	木 束 丷
疃	田 童
篁	竹头 白 王
芤	艹 子 乛
蚬	虫 见
钋	钅 卜
钲	钅 正
镆	钅 莫
呒	口 无
楦	木 宀 一 旦
畀	田 丌
痱	疒 非
鸶	丝左角 丝左角 一 鸟
垡	亻 戈 土
缣	纟 䒑 聿三 兼无䒑无彐
阊	门 日 日
骱	骨 介
偾	亻 十 艹 贝
廛	广 里 八 土
瓴	今 丶 瓦
脔	变字头 肉
舨	舟 反字框 又
葎	艹 彳 聿
迓	牙 辶
喾	学无子 告字头 口
崞	山 享字头 子
帔	巾 皮
殄	歹 全字头 彡
甙	弋 甘
畋	田 攵
痧	疒 氵 少
秫	禾 木 丶
窳	穴 瓜 瓜
羧	差字头 厶 八 夂
艽	艹 九
葑	艹 圭 寸
蛏	虫 又 土
蜣	虫 差字头 乛
蠛	虫 艹 罒 戊 丶
踟	足旁 矢 口
逑	求 辶
醣	酉 唐
钣	钅 反字框 又
镔	钅 宀 兵
颎	匕 火 页
驺	马 刍
髑	骨 罒 勹 虫
黧	禾 黎右角 黑
鼗	儿 率字腰 壴 支
硖	石 夹
罟	罒 古
裎	衤 口 王
蹰	足旁 厂 豆 寸
邰	厶 口 阝
髌	骨 宀 兵
麸	麦 夫
岵	山 古
暌	日 癶 天
暝	日 冖 日 六
欹	大 可 欠
窀	穴 屯
蓼	艹 羽 全字头 彡
骘	阝 止 步字底 马
孥	女 又 子
幛	巾 立 早
愦	忄 贵字头 贝
曩	日 衣框 吅 寒字腰
泔	氵 甘
溘	氵 去 皿
粝	米 厂 万
肷	月 欠
荽	艹 爫 女
薹	艹 士 口 冖 至
蚶	虫 甘
衄	血 录字头 丨
裉	衤 艮
钎	钅 千
钭	钅 斗
镬	钅 艹 隹 又
鹈	丷 弓 弟省无弓 鸟
圉	囗 土 南字心
嫘	女 田 糸
旒	旅字框 㐬
箪	竹头 丷 旦 丨
粢	冫 欠 米
裼	衤 日 勹 横两撇
酃	雨头 口 口 口 阝
殳	殳
瀣	氵 歺 又 非 一
皤	白 釆 田
睃	目 厶 八 夂
脘	月 宀 元
莪	艹 我
跫	工 凡 足
哌	口 反字框 旅下角
彘	彑 比字旁 矢 匕
甯	宀 心 甬字底
疠	疒 万
疴	疒 可
罾	罒 丷 曾字头无丷 日
胙	月 乍
蚰	虫 由
螬	虫 一 曲 日
谵	讠 尔字头 厂 八 言
鄞	革 二 阝
醵	酉 虍 豕
鐾	辟 金
钌	钅 了
隹	隹
鳔	鱼 覀 示
鳢	鱼 曲 豆
鹪	隹 灬 鸟
旄	旅字框 毛
绨	纟 丷 弓 弟省无弓
蕖	艹 氵 匸 叚右角 木
虮	虫 几
蝽	虫 春字头 日
尥	尢 勹 丶
煳	火 古 月
玎	王 丁
璁	王 囱 心
罱	罒 十 冂 南字心
萑	艹 隹
钫	钅 方
锱	钅 巛 田
悱	忄 非
憷	忄 林 疋
捩	扌 户 犬
榱	木 衣框 口 一
濞	氵 鼻
瑷	王 爱字头 友
砹	石 艹 乂
磴	石 癶 豆
窨	穴 音
篦	竹头 囟 比
蘼	艹 麻 非
螽	夂 冬字底 虫 虫
褊	衤 户 扁字心
貔	豸 囟 比
跖	足旁 石
辊	车旁 日 比
逯	录字头 氺 辶
嵝	山 娄
糗	米 自 犬
蝣	虫 旅字框 子
鳚	鱼 尸 示 寸
麇	鹿 禾
曛	日 千 黑
湔	氵 䒑 青字底 刂
癔	疒 音 心
肜	月 彡
醐	酉 古 月
庀	广 匕
猡	犭 罒 夕
玢	王 分
皴	厶 八 夂 皮
筇	竹头 工 阝
艨	舟 荧字头 一 豕
袼	衤 各
轫	车旁 刀 丶
逭	宀 㠯 辶
遄	山 而 辶
钯	钅 巴
髀	骨 卑
敫	白 方 攵
朊	月 元
槔	木 白 大 十
沔	氵 丅 乛 乛
泶	学无子 水
浼	氵 免五 儿
犸	犭 马
苊	艹 厂 㔾
蒌	艹 娄
薅	艹 女 辰 寸
蛲	虫 尧字头 丆 乛
蹀	足旁 廿 乛 木
酽	酉 亚 丿
鲔	鱼 左字框 青字底
鹾	卤 差字头 工
嵛	山 亼 青字底 刂
樘	木 尚头 土
獍	犭 音 儿
祆	礻 天
窭	穴 娄
銎	工 凡 金
喱	口 厂 里
捭	扌 卑
湓	氵 分 皿
缡	纟 㐫 禸
藁	艹 高 木
迕	卧人 十 辶
酐	酉 干
偬	亻 勹 横两撇 丶 心
搴	寒字头 手
瞋	目 直 八
砬	石 立
肭	月 内
舾	舟 西
莩	艹 爫 子
葚	艹 其 乛
鲃	鱼 巴
鹱	鸟 艹 隹 又
侉	亻 大 亏
渖	氵 宀 日 丨
璩	王 虍 豕
篯	竹头 钅 戋
糇	米 亻 候右角 矢
芑	艹 己
褰	寒字头 衣
铋	钅 心 丿
鳙	鱼 广 肀 甬字底
仫	亻 丿 厶
岣	山 句
庹	度字框 尺
戥	日 生 戈
杪	木 少
漯	氵 田 糸
甾	巛 田
籼	米 山
肀	肀
锊	钅 爫 寸
哏	口 艮
敉	米 攵
溏	氵 唐
燹	豕 豕 火
穸	穴 夕
豉	豆 支
酡	酉 宀 匕
醭	酉 业 养字头
钇	钅 乙
铒	钅 耳
铯	钅 尔字头 巴
锼	钅 臼 丨 又
鞔	革 免五 儿
鲚	鱼 齐
磙	石 衣框 公
祕	礻 心 丿
菘	艹 木 公
钔	钅 门
锜	钅 大 可
炱	厶 口 火
茭	艹 交
锿	钅 衣框 口
骢	马 囱 心
仡	亻 卧人 乙
垴	土 㐫
搠	扌 䒑 䶹 月
炻	火 石
琚	王 居
疳	疒 甘
砜	石 风
镗	钅 尚头 土
隰	阝 日 幺 幺 灬
鸺	亻 木 鸟
刿	山 夕 刂
桤	木 山 己
瓿	咅 瓦
缧	纟 田 糸
荸	艹 索字头 子
菡	艹 了 率字腰 凵
馇	饣 木 旦
鳇	鱼 白 王
栌	木 卢字头 尸
溲	氵 臼 丨 又
艚	舟 一 曲 日
锝	钅 旦 寸
鹮	罒 同字心 衣省 鸟
仵	亻 卧人 十
嶷	山 匕 矢 龴 疋
殍	歹 爫 子
煺	火 艮 辶
羼	尸 羊 差字头 羊
葜	艹 丰 刀 大
谂	讠 今 心
镅	钅 眉字框 目
鲷	鱼 周字框 土 口
吣	口 心
哿	力 口 可
氙	气 山
硭	石 芒
窆	穴 丿 之
窬	穴 亼 青字底 刂
筌	竹头 全字头 王
蒴	艹 䒑 䶹 月
蟥	虫 黄
铑	钅 老
锍	钅 㐬
鸸	而 鸟
橥	犭 者 木
甓	辟 瓦
硇	石 囟
苒	艹 冉
蒡	艹 立无横 冖 方
鞲	革 寒字腰 冉
鸲	句 鸟
喹	口 大 圭
檠	艹 句 攵 木
涠	氵 囗 韦
爨	臼裂 冂 同字心 冖 林 大 火
艟	舟 童
葳	艹 戊 一 女
跶	足旁 大 辶
辂	车旁 各
邴	一 内 阝
镓	钅 宀 豕
髟	镸 彡
铙	钅 尧字头 丆 乛
锪	钅 勹 横两撇 心
胩	月 上 卜
镄	钅 弗 贝
眬	目 龙
蕤	艹 豕 生
龢	龠 禾
翥	者 羽
耒	耒
躔	足旁 广 里 八 土
黥	黑 京
箬	竹头 艹 左字框 口
谮	讠 旡 旡 日
戢	口 耳 戈无一
檑	木 雨头 田
訾	此 言
襦	衤 雨头 而
歃	千 臼 欠
瘌	疒 束 刂
潋	氵 亼 应字心 攵
纛	龶 母 具字头 小 丿 糸
蓍	艹 老 日
徼	彳 白 方 攵
杌	木 丆 乛
滹	氵 虍 乊 于无横
爿	爿
芈	临字旁 三 卢字头
狴	犭 比 土
玟	王 文
眭	目 圭
貅	豸 亻 木
郜	告字头 口 阝
娈	变字头 女
嫫	女 莫
搦	扌 弓 冫 弓 冫
瑗	王 爫 一 友
柰	木 示
殂	歹 且
糨	米 弓 口 虫
绐	纟 厶 口
沭	氵 木 丶
犴	犭 干
蕈	艹 覀 早
谳	讠 十 冂 南字心 犬
坻	土 氏 丶
尻	尸 九
怿	忄 又 举字底
棹	木 卢字头 早
翮	鬲 羽
耋	老 至
阼	阝 乍
骝	马 留字头 田
撄	扌 贝 贝 女
柒	氵 七 木
侑	亻 左字框 青字底
悝	忄 里
洇	氵 囗 大
燠	火 向字框 米 大
坩	土 甘
妧	女 元
媵	月 龹 女
廨	广 角 刀 牛
徂	彳 且
旰	日 干
洎	氵 自
澌	氵 其 斤
缵	纟 先 先 贝
裒	衣框 臼
觇	占 见
崦	山 大 电
耧	耒 娄
轺	车旁 刀 口
镝	钅 立无横 冂 古
霪	雨头 氵 爫 壬
喈	口 比 白
眚	生 目
剡	火 火 刂
卺	氶 一 㔾
哓	口 尧字头 丆 乛
怍	忄 乍
悛	忄 厶 八 夂
昝	夂 卜 日
柙	木 甲
栊	木 龙
棰	木 垂
绂	纟 友 丶
莳	艹 日 寸
蒹	艹 䒑 聿三 兼无䒑无彐
蓐	艹 辰 寸
蚺	虫 冉
觚	角 瓜
貊	豸 百
鬲	鬲
嵫	山 䒑 幺 幺
幞	巾 业 养字头
梃	木 壬 廴
滏	氵 父 金字底
瘗	疒 夹 土
蓊	艹 公 羽
蠃	赢字框 虫
豳	山 豕 豕
遘	寒字腰 冉 辶
锞	钅 果
雩	雨头 亏
呙	呙
秭	禾 姊字边
茕	荧字头 乛 十
蕞	艹 日 耳 又
蝰	虫 大 圭
邾	丿 未 阝
仝	全字头 工
伛	亻 区
堠	土 亻 候右角 矢
悫	壳字头 几 心
暾	日 享字头 子 攵
祧	礻 儿 率字腰
筅	竹头 先
缑	纟 亻 候右角 矢
腩	月 十 冂 南字心
蒽	艹 囗 大 心
豸	豸
踣	足旁 咅
轵	车旁 只
陬	阝 耳 又
颟	艹 两 页
骖	马 厶 大 彡
麈	鹿 主
黻	业 㡀 友 丶
刳	大 亏 刂
哕	口 山 夕
帻	巾 龶 贝
桫	木 氵 少
荑	艹 大框 弓
蹁	足旁 户 扁字心
隈	阝 田 一 畏字底
骟	马 户 羽
佾	亻 八 青字底
剀	山 己 刂
埒	土 爫 寸
埸	土 日 勹 横两撇
攮	扌 囊字头 吅 寒字腰 衣省
栲	木 耂 丂
栳	木 老
泺	氵 乐二 小
洧	氵 左字框 青字底
糌	米 夂 卜 日
荦	荧字头 牛
赙	贝 甫 寸
鲥	鱼 日 寸
圬	土 亏
圯	土 巳
塄	土 罒 方
妣	女 比
忭	忄 亠 卜
慝	匚 艹 左字框 口 心
椟	木 卖字头 冬字底 大
犰	犭 九
瘳	疒 羽 全字头 彡
耜	耒 㠯
茌	艹 亻 士
荇	艹 行
蛸	虫 尚字头 青字底
贳	廿 乛 贝
踬	足旁 反字框 十 贝
郄	乂 左字框 厶 阝
铗	钅 夹
颃	亠 几 页
仳	亻 比
刭	经右角 工 刂
劓	鼻 刂
哚	口 几 木
唣	口 白 七
坜	土 厂 力
屣	尸 彳 止 龰
惝	忄 尚
掎	扌 大 可
擐	扌 罒 同字心 衣省
晡	日 甫
柝	木 斤 丶
柽	木 又 土
檎	木 全字头 㐫 禸
溷	氵 囗 豕
瀹	氵 龠
猞	犭 全字头 舍字底
疔	疒 丁
癀	疒 黄
簋	竹头 艮 皿
絷	执 糸
缌	纟 田 心
葸	艹 田 心
蓥	荧字头 金
蘧	艹 虍 豕 辶
趑	走 冫 欠
趱	走 先 先 贝
邗	干 阝
郐	全字头 云 阝
郫	卑 阝
锔	钅 尸 乛 口
镡	钅 覀 早
陴	阝 卑
颡	又 双 木 页
骐	马 其
叻	口 力
噍	口 隹 灬
圹	土 广
垧	土 向字框 口
埭	土 隶字框 率字腰
埴	土 直
屦	尸 彳 娄
廑	广 革 二
悃	忄 囗 木
拶	扌 巛 夕
昃	日 厂 人
桴	木 爫 子
氍	目 目 隹 毛
猁	犭 禾 刂
瘐	疒 臼 人
砑	石 牙
箜	竹头 穴 工
篚	竹头 匚 非
绁	纟 廿 乛
缳	纟 罒 同字心 衣省
芘	艹 比
萁	艹 其
蓁	艹 春字头 禾
蓠	艹 㐫 禸
酹	酉 爫 寸
镪	钅 弓 口 虫
馘	首 戈 口 一
鳐	鱼 爫 缶
垆	土 卢字头 尸
堙	土 覀 土
怃	忄 无
扃	户 冂 口
撙	扌 酋 寸
殪	歹 壳字头 豆
毳	毛 毛 毛
浍	氵 全字头 云
溱	氵 春字头 禾
狺	犭 言
珙	王 共
瘰	疒 田 糸
眄	目 丅 乛 乛
礅	石 享字头 子 攵
菰	艹 子 瓜
蕻	艹 镸 共
蜩	虫 周字框 土 口
觋	工 从 见
贶	贝 兄
郇	勹 日 阝
镩	钅 穴 口 中
髹	镸 彡 亻 木
黟	黑 夕 夕
佴	亻 耳
坫	土 占
坼	土 斤 丶
埝	土 今 心
岈	山 牙
岙	夭 山
彖	彑 豕省
戽	户 斗
掊	扌 咅
揸	扌 木 旦
摅	扌 虍 心
杩	木 马
枘	木 内
柁	木 宀 匕
栝	木 舌
沩	氵 丶 力 丶
溽	氵 辰 寸
牾	牜 五 口
狃	犭 录字头 丨
珉	王 民
皲	冖 车旁 皮
瞀	矛 攵 目
矧	矢 弓 丨
筚	竹头 比 十
筲	竹头 尚字头 青字底
箨	竹头 扌 又 举字底
篼	竹头 白 卬字旁 叚右角 儿
糈	米 疋 青字底
糍	米 䒑 幺 幺
綮	户 攵 糸
绗	纟 行
羝	差字头 氏 丶
舄	臼 勹 灬
舳	舟 由
艋	舟 子 皿
茆	艹 卯
茛	艹 艮
茳	落字框 工
荜	艹 比 十
蔸	艹 白 卬字旁 叚右角 儿
薤	艹 歹 非 一
蝾	虫 荧字头 木
觌	卖字头 冬字底 大 见
觜	此 角
貘	豸 莫
趵	足旁 勹 丶
跽	足旁 己 心
轹	车旁 乐二 小
辋	车旁 冂 䒑 亡
酎	酉 寸
酤	酉 古
铫	钅 儿 率字腰
镥	钅 鱼 日
陔	阝 亥
骀	马 厶 口
髫	镸 彡 刀 口
鲵	鱼 臼 儿
鲼	鱼 十 艹 贝
鹣	䒑 聿三 兼无䒑无彐 鸟
龠	龠
仉	亻 几
垲	土 山 己
埕	土 口 王
妁	女 勹 丶
孓	了 丶
忉	忄 刀
忮	忄 支
戋	戋
揠	扌 匚 日 女
桄	木 光
桷	木 角
棼	林 分
檫	木 宀 祭字头 示
毹	亼 青字底 刂 毛
洫	氵 血
滠	氵 耳 双
漭	氵 艹 犬 廾
爝	火 爫 罒 即字旁 寸
狳	犭 全字头 余字底
珧	王 儿 率字腰
畎	田 犬
疬	疒 厂 力
痦	疒 五 口
瘊	疒 亻 候右角 矢
瘼	疒 莫
瞢	艹 罒 冖 目
祓	礻 友 丶
籀	竹头 扌 留字头 田
纩	纟 广
聱	敖字旁 攵 耳
脞	月 从 土
腠	月 春字头 天
莨	艹 丶 艮
萆	艹 卑
蒉	艹 贵字头 贝
蕺	艹 口 耳 戈无一
蝤	虫 酋
蝻	虫 十 冂 南字心
襻	衤 木 乂 乂 木 大 手
觏	寒字腰 冉 见
赆	贝 尺 冬字底
趼	足旁 开
醅	酉 咅
铊	钅 宀 匕
镲	钅 宀 祭字头 示
阽	阝 占
鲽	鱼 廿 乛 木
鳜	鱼 厂 䒑 䶹 欠
鹇	门 木 鸟
儇	亻 罒 同字心 衣省
劂	厂 䒑 䶹 欠 刂
坌	分 土
坭	土 尸 匕
埏	土 延字心 廴
埤	土 卑
帱	巾 寿字头 寸
恧	而 心
枧	木 见
楗	木 聿 廴
檗	辟 木
汆	入 水
汔	氵 卧人 乙
淠	氵 田 丌
漶	氵 口 中 心
澉	氵 乛 耳 攵
狁	犭 厶 儿
璺	臼裂 冂 同字心 冖 玉
甍	艹 罒 冖 瓦
瘵	疒 祭字头 示
禊	礻 丰 刀 大
箦	竹头 龶 贝
篌	竹头 亻 候右角 矢
绠	纟 更
舴	舟 乍
葶	艹 亮字头 丁
蔟	艹 旅字框 矢
襞	辟 衣
觖	角 夬
赇	贝 求
躐	足旁 巛 巤字底
躜	足旁 先 先 贝
轾	车旁 至
邡	方 阝
骒	马 果
鬏	镸 彡 禾 火
鲞	龹 鱼
鳘	卧人 母 攵 鱼
黉	学无子 黄
鼷	鼠 爫 幺 大
俜	亻 由 丂
傺	亻 祭字头 示
僬	亻 隹 灬
冱	冫 一 彑
剞	大 可 刂
劁	隹 灬 刂
哳	口 扌 斤
唪	口 春字头 举字底
唼	口 妾
垌	土 冂 同字心
垸	土 宀 元
埚	土 呙
堍	土 兔
塍	月 龹 土
墁	土 日 罒 又
墼	車 凵 殳 土
夼	大 川
尜	小 大 小
屺	山 己
岜	山 巴
岽	山 东二 小
庳	广 卑
廒	广 敖字旁 攵
彳	彳
恝	丰 刀 心
捃	扌 君
搌	扌 尸 展字心
搛	扌 䒑 聿三 兼无䒑无彐
攉	扌 雨头 隹
枨	木 长
柃	木 今 丶
桊	龹 木
桕	木 臼
椐	木 居
椠	车旁 斤 木
椹	木 其 乛
榍	木 尸 尚字头 青字底
樨	木 尸 犀字心头 牛
橼	木 纟 彑 豕省
毵	厶 大 彡 毛
氆	毛 䒑 业 日
泐	氵 阝 力
泖	氵 卯
浈	氵 卢字头 贝
溻	温字框 羽
滗	氵 竹头 毛
潲	氵 禾 尚字头 青字底
瀵	氵 米 田 共
犋	牜 具字头 八
猃	犭 亼 应字心
甏	壴 彡 瓦
瘕	疒 叚
瘥	疒 差字头 工
癃	疒 阝 夂 一 生
癍	疒 王 文 王
眍	目 区
眢	夕 㔾 目
眵	目 夕 夕
瞍	目 臼 丨 又
瞵	目 米 舛
砘	石 屯
碹	石 宀 一 旦
磲	石 氵 匸 叚右角 木
礓	石 一 田 一 田 一
稂	禾 丶 艮
筢	竹头 扌 巴
箢	竹头 宀 夕 㔾
篥	竹头 覀 木
簏	竹头 鹿
绋	纟 弗
缲	纟 口 吅 木
罨	罒 大 电
耩	耒 寒字腰 冉
脬	月 爫 子
腧	月 亼 青字底 刂
臌	月 壴 支
舣	舟 丶 乂
舯	舟 中
艴	弗 尔字头 巴
芴	艹 勹 横两撇
茚	艹 印字旁 卩
茺	艹 充字头 儿
茼	艹 冂 同字心
莛	艹 壬 廴
萏	艹 负字头 臼
蒇	艹 戊 贝
蓰	艹 彳 止 龰
蔌	艹 束 欠
蜞	虫 其
蝓	虫 亼 青字底 刂
蝥	矛 攵 虫
褙	衤 北 青字底
豇	豆 工
赕	贝 火 火
蹯	足旁 釆 田
邶	北 阝
酞	酉 太
酲	酉 口 王
酴	酉 全字头 余字底
酾	酉 一 丽下角 丽下角
钐	钅 彡
钬	钅 火
铴	钅 氵 乛 横两撇
锇	钅 我
锬	钅 火 火
锾	钅 爫 一 友
镘	钅 日 罒 又
陧	阝 日 土
霈	雨头 氵 丙三 丨
顸	干 页
颥	雨头 而 页
飑	风 包
驵	马 且
鲦	鱼 夂 朩
鲭	鱼 龶 青字底
鲳	鱼 日 日
鹛	眉字框 目 鸟
黹	业 㡀
鼢	鼠 分
亍	亍
仂	亻 力
劐	艹 隹 又 刂
叆	云 爱字头 友
吲	口 弓 丨
唛	口 麦
嚆	口 艹 高
圊	囗 龶 青字底
垤	土 至
埘	土 日 寸
埯	土 大 电
墚	土 氵 刀 横两点 木
嫜	女 立 早
嬲	田 力 女 田 力
岍	山 开
巯	经右角 工 㐬
戤	乃 又 皿 戈
掭	扌 天 恭字底
枞	木 从
槠	木 讠 者
洚	氵 夂 㐄
炘	火 斤
烀	火 乊 于无横
牿	牜 告字头 口
犏	牜 户 扁字心
猹	犭 木 旦
疰	疒 主
瘃	疒 豕 丶
砟	石 乍
砦	此 石
砼	石 全字头 工
碲	石 立无横 冖 巾
磉	石 又 双 木
稆	禾 吕
筘	竹头 扌 口
筻	竹头 更
粞	米 西
耔	耒 子
耠	耒 合
耱	耒 麻 石
耵	耳 丁
聍	耳 宀 丁
胬	女 又 肉
胲	月 亥
脒	月 米
腽	月 日 皿
膦	月 米 舛
舭	舟 比
苈	艹 厂 力
苘	艹 冂 口
茈	艹 此
荬	艹 乛 冬字底 大
菝	艹 扌 友 丶
菪	艹 宀 石
萜	艹 巾 占
蕹	艹 亠 乡 隹
薷	艹 雨头 而
蜱	虫 卑
蜾	虫 果
螋	虫 臼 丨 又
螵	虫 覀 示
觫	角 束
谫	讠 䒑 青字底 刂 刀
踺	足旁 聿 廴
躞	足旁 言 火 火 又
辁	车旁 全字头 王
迮	乍 辶
邛	工 阝
鄹	耳 又 乑 阝
醑	酉 疋 青字底
钽	钅 旦
铈	钅 亠 巾
铌	钅 尸 匕
铘	钅 牙 阝
铞	钅 口 巾
铟	钅 囗 大
铪	钅 合
铼	钅 来
锎	钅 门 开
锓	钅 彐 冖 又
锖	钅 龶 青字底
锘	钅 艹 左字框 口
锫	钅 咅
镎	钅 合 手
镦	钅 享字头 子 攵
镨	钅 䒑 业 日
镱	钅 音 心
骍	马 辛
骣	马 尸 子 子 子
鲒	鱼 士 口
鲣	鱼 贤字头 土
鲩	鱼 宀 元
鲻	鱼 巛 田
鹋	艹 田 鸟
鹎	卑 鸟
黪	黑 厶 大 彡
鼯	鼠 五 口
㑇	亻 刍
㑊	亻 亠 亦字底
㕮	口 父
㘎	口 门 乛 耳 攵
㙍	土 双 双
㙘	土 覀 女
㙦	全字头 余字底 斗 土
㛃	丰 刀 女
㛚	女 龴 甬字底
㛹	女 亻 更
㟃	山 乛 同字心
㠇	山 京 尤
㠓	山 荧字头 一 豕
㤘	忄 刍
㥄	忄 土 八 夂
㧐	扌 双
㧑	扌 丶 力 丶
㧟	扌 氵 匚
㫰	日 丶 艮
㬊	日 爫 一 友
㬎	日 幺 幺 灬
㬚	日 充字头 青字底 攵
㭎	木 冂 乂
㭕	木 去
㮾	丶 即字旁 月 木
㰀	木 禾 黎右角 全字头 氺
㳇	氵 父
㳘	氵 充字头 儿
㳚	氵 戊 丶
㴔	氵 刍 心
㵐	氵 厂 䒑 䶹 欠
㶲	火 用
㸆	火 告字头 口 非
㸌	火 雨头 隹
㺄	犭 亼 青字底 刂
㻬	王 雨头 亏
㽏	氵 合 甘
㿠	白 光
䁖	目 娄
䂮	丰 刀 石
䃅	石 丷 旦 丨
䃎	石 大 夕 夕
䅟	禾 厶 大 彡
䌹	纟 冂 口
䎃	冉 羽
䎖	丷 曾字头无丷 日 羽
䏝	月 专
䏡	月 示
䏲	月 丷 弓 弟省无弓
䐃	月 囗 禾
䓖	艹 穴 力
䓛	艹 尸 屮 凵
䓨	荧字头 缶
䓫	艹 大 可
䓬	艹 卢字头 早
䗖	虫 带字头 冖 巾
䗛	虫 修字旁 夂 青字底
䗪	度字框 灬 虫
䗴	虫 竹头 壬 廴
䜣	讠 斤
䝙	豸 区
䢺	屮 凵 阝
䢼	共 阝
䣘	尚头 土 阝
䥽	钅 发
䦃	钅 艹 者
䲟	鱼 印字旁 卩
䲠	鱼 春字头 日
䲢	月 龹 鱼
䴓	一 巾 鸟
䴔	交 鸟
䴕	歹 刂 鸟
䴖	龶 青字底 鸟
䴗	目 犬 鸟
䴘	反字框 虎 鸟
䴙	辟 鸟
䶮	龙 天
丏	丅 乛 乛
乂	乂
乸	也 母
亶	亠 囗 口 旦
亸	享字头 子 丷 旦 丨
亹	亠 臼裂 冂 同字心 冖 且
伈	亻 心
伋	亻 及
伣	亻 见
伭	亻 亠 幺
伾	亻 不 一
佁	亻 厶 口
佖	亻 心 丿
佸	亻 舌
佺	亻 全字头 王
佽	亻 冫 欠
侁	亻 先
侂	亻 广 丿 七
侘	亻 宀 丿 七
侴	亼 录字头 丨 刂
侹	亻 壬 廴
俍	亻 丶 艮
俙	亻 乂 左字框 巾
俫	亻 来
俵	亻 龶 衣省
俶	亻 上 小 又
倓	亻 火 火
倕	亻 垂
倞	亻 京
倧	亻 宀 示
倴	亻 大 十 廾
倻	亻 耳 阝
偁	亻 爫 冉
偓	亻 尸 至
偡	亻 其 乛
偭	亻 面
偰	亻 丰 刀 大
偲	亻 田 心
傃	亻 龶 糸
傉	亻 辰 寸
傒	亻 爫 幺 大
傕	亻 冖 隹
僇	亻 羽 全字头 彡
僎	亻 巳 巳 共
僔	亻 酋 寸
僰	木框 冂 木框 冂 人
儦	亻 鹿 灬
儳	亻 免五 比 兔
儴	亻 衣框 吅 寒字腰
冏	𠕉字底 口
冔	冒字头 口 一 于无横
冮	冫 工
凓	冫 覀 木
凘	冫 其 斤
刬	戋 刂
剅	豆 刂
剋	古 儿 刂
剕	非 刂
剟	双 双 刂
劄	竹头 合 刂
劼	士 口 力
勍	京 力
勔	面 力
勚	廿 乛 贝 力
勠	羽 全字头 彡 力
匜	匚 也
匼	匚 合
卬	卬字旁 卩
厖	厂 龙 纵两撇
厾	乛 去
叇	云 隶字框 率字腰 辶
叕	双 双
叚	叚
吖	口 丷 丨
吽	口 牛
呇	水 口
呣	口 母
咇	口 心 丿
咉	口 见二 大
咍	口 厶 口
咡	口 耳
咥	口 至
咺	口 一 旦
哃	口 冂 同字心
哢	口 王 廾
哱	口 索字头 子
唝	口 工 贝
唵	口 大 电
啰	口 罒 夕
啴	口 丷 旦 丨
喆	士 口 士 口
喤	口 白 王
嗞	口 䒑 幺 幺
嘚	口 彳 旦 寸
嘡	口 尚头 土
噀	口 巳 巳 共
噂	口 酋 寸
噇	口 童
嚄	口 艹 隹 又
嚚	吅 臣 吅
嚭	壴 口 不 口
囷	囗 禾
圌	囗 山 而
圐	囗 罒 方
圙	囗 八 面
圢	土 丁
圫	土 丿 七
圲	土 千
坉	土 屯
坋	土 分
坒	比 土
坥	土 且
坬	土 瓜
坰	土 冂 口
坽	土 今 丶
垈	亻 弋 土
垍	土 自
垎	土 各
垏	土 聿
垕	后字框 口 土
垙	土 光
垚	土 土 土
垞	土 宀 丿 七
垟	土 羊
垯	土 大 辶
垱	土 尚字头 彐
垵	土 宀 女
垺	土 爫 子
垾	土 日 干
垿	土 广 予
埆	土 角
埇	土 龴 甬字底
埌	土 丶 艮
埗	土 止 步字底
埪	土 穴 工
埫	土 尚
埵	土 垂
埼	土 大 可
堃	方 方 土
堉	土 充字头 青字底
堌	土 囗 古
堎	土 土 八 夂
堐	土 厂 圭
堧	土 而 大
堨	土 曷
堲	即字旁 卩 土
堼	圭 寸 土
堽	土 罒 正
堾	土 春字头 日
塅	土 段字旁 殳
塆	土 变字头 弓
塝	土 立无横 冖 方
塥	土 鬲
塱	丶 即字旁 月 土
墈	土 其 乛 力
墐	土 革 二
墕	土 正 与无横 灬
墘	土 龺 卧人 乙
墡	土 羊 䒑 口
墣	土 业 养字头
墦	土 釆 田
壸	壳字头 亚
夐	负字头 见二 全字头 目 夂
夬	夬
奓	大 夕 夕
奡	丆 目 大 乔字底
奭	大框 百 百
妘	女 云
妭	女 友 丶
姈	女 今 丶
姞	女 士 口
姤	女 后字框 口
姮	女 一 旦
姱	女 大 亏
姶	女 合
姽	女 尔字头 厂 㔾
娀	女 戈 左字框
娵	女 耳 又
婌	女 上 小 又
婍	女 大 可
婘	女 龹 㔾
婞	女 土 南字心
婠	女 宀 㠯
婤	女 周字框 土 口
婫	女 日 比
婳	女 一 田 凵
婻	女 十 冂 南字心
婼	女 艹 左字框 口
媂	女 立无横 冖 巾
媄	女 美字头 大
媆	女 而 大
媓	女 白 王
媖	女 艹 见二 大
媞	女 是
媭	彡 页 女
媱	女 爫 缶
嫄	女 原
嫕	女 匚 矢 心
嫚	女 日 罒 又
嫪	女 羽 全字头 彡
嫭	女 虍 乊 于无横
嫽	女 大 丷 日 小
嬛	女 罒 同字心 衣省
嬬	女 雨头 而
嬿	女 廿 口 北字旁 匕 灬
孅	女 从 戈 非 一
孖	子 子
宧	宀 颐字旁
宬	宀 成三 戈无一
寁	宀 一 聿三 龰
尢	尢
尨	龙 纵两撇
尪	尢 王
屃	尸 贝
屼	山 丆 乛
屾	山 山
岊	巴 山
岞	山 乍
岠	山 匸 叚右角
岨	山 且
峂	山 夂 冬字底
峃	学无子 山
峗	山 尔字头 厂 㔾
峘	山 一 旦
峛	山 歹 刂
峣	山 尧字头 丆 乛
峧	山 交
峱	犭 录字头 丨 山
峿	山 五 口
崀	山 丶 艮
崁	山 土 欠
崄	山 亼 应字心
崌	山 居
崒	山 亠 从 十
崚	山 土 八 夂
崟	山 金
崡	山 了 率字腰 凵
崶	山 圭 寸
崿	山 吅 亏
嵁	山 其 乛
嵅	山 戊 同字心
嵎	山 日 禺字底
嵖	山 木 旦
嵚	山 钅 欠
嵲	山 自 木
嶅	敖字旁 攵 山
嶍	山 羽 白
嶒	山 丷 曾字头无丷 日
嶓	山 釆 田
嶟	山 酋 寸
嶦	山 尔字头 厂 八 言
嶲	山 隹 雋字底
巇	山 虍 豆 戈
巉	山 免五 比 兔
帡	巾 丷 开
帨	巾 丷 兄
幖	巾 覀 示
幪	巾 荧字头 一 豕
庤	广 土 寸
庱	广 土 八 夂
庼	广 比字旁 页
廆	广 鬼
廋	广 臼 丨 又
廙	广 田 共
弆	去 廾
弇	合 廾
弢	弓 屮 又
弨	弓 刀 口
弶	弓 京
弸	弓 月 月
彟	彐 寸 艹 隹 又
彧	戈 口 一 纵两撇
徛	彳 大 可
忞	文 心
忳	忄 屯
忺	忄 欠
怊	忄 刀 口
恓	忄 西
恔	忄 交
悆	全字头 余字底 心
悈	忄 戈 廾
悢	忄 丶 艮
悰	忄 宀 示
惇	忄 享字头 子
惎	其 心
惔	忄 火 火
惙	忄 双 双
惛	忄 氏 日
愃	忄 宀 一 旦
愐	忄 面
愔	忄 音
愭	忄 老 日
慆	忄 爫 臼
慥	忄 告字头 口 辶
慬	忄 革 二
慭	来 犬 心
憕	忄 癶 豆
憙	壴 口 心
憭	忄 大 丷 日 小
憺	忄 尔字头 厂 八 言
戣	癶 天 戈
戭	宀 一 由 八 戈
扂	户 占
扅	户 夕 夕
扆	户 衣
扊	户 火 火
扞	扌 干
扺	扌 氏
扽	扌 屯
抃	扌 亠 卜
抔	扌 不
拃	扌 乍
拤	扌 上 卜
挓	扌 宀 丿 七
挦	扌 彐 寸
捯	扌 至 刂
捽	扌 亠 从 十
掞	扌 火 火
揕	扌 其 乛
揳	扌 丰 刀 大
搋	扌 反字框 虎
搒	扌 立无横 冖 方
摏	扌 春字头 臼
摛	扌 㐫 禸
摴	扌 雨头 亏
摽	扌 覀 示
撖	扌 乛 耳 攵
擿	扌 立无横 冂 古 辶
攽	分 攵
敔	五 口 攵
敩	学无子 子 攵
斝	吅 冖 斗
斠	寒字腰 冉 斗
斶	斤 罒 勹 虫
旐	旅字框 儿 率字腰
旞	旅字框 丷 豕 辶
旴	日 一 于无横
旵	日 山
旸	日 乛 横两撇
旻	日 文
旿	日 卧人 十
昄	日 反字框 又
昇	日 丿 廾
昈	日 户
昉	日 方
昒	日 勹 横两撇
昡	日 亠 幺
昣	日 全字头 彡
昤	日 今 丶
昪	日 厶 廾
昫	日 句
昳	日 丿 夫
昺	日 一 内
昽	日 龙
晅	日 一 旦
晊	日 至
晐	日 亥
晙	日 厶 八 夂
晞	日 乂 左字框 巾
晢	扌 斤 日
晪	日 典字头 一 八
晫	日 卢字头 早
晱	日 火 火
暅	日 忄 一 旦
暕	日 束 丷
暲	日 立 早
暵	日 廿 口 夫
暶	日 旅字框 疋
暿	日 壴 口
曈	日 童
曌	日 月 穴 工
朏	月 屮 凵
朓	月 儿 率字腰
朳	木 八
朸	木 力
杄	木 千
杕	木 大
杙	木 弋
杧	木 亡
杻	木 录字头 丨
枅	木 开
枍	木 八 丂
枲	厶 口 木
枹	木 包
柈	木 半
柊	木 夂 冬字底
柖	木 刀 口
柷	木 兄
栐	木 丶 永无点
栒	木 勹 日
栟	木 丷 开
栴	木 卧人 丹
栻	木 弋 工
桯	木 口 王
桲	木 索字头 子
桹	木 丶 艮
梌	木 全字头 余字底
梠	木 吕
梣	木 山 今
梴	木 延字心 廴
梼	木 寿字头 寸
梽	木 士 心
梾	木 来
梿	木 车 辶
棁	木 丷 兄
棐	非 木
棓	木 咅
棤	木 龷 日
棨	户 攵 木
棪	木 火 火
棫	木 戈 口 一
棬	木 龹 㔾
棻	艹 分 木
棽	林 今
椀	木 宀 夕 㔾
椆	木 周字框 土 口
椑	木 卑
椓	木 豕 丶
椪	木 䒑 业
椸	木 旅字框 也
楒	木 田 心
楙	木 矛 木
楩	木 亻 更
楪	木 廿 乛 木
楯	木 反字框 十 目
榃	林 田
榅	木 日 皿
榑	木 甫 寸
榖	壳字头 一 木 殳
榰	木 老 日
槃	舟 殳 木
槚	木 覀 贝
槜	木 隹 乃
槱	木 酉 灬
橑	木 大 丷 日 小
橞	木 凬字心 虫无口 心
橦	木 童
檞	木 角 刀 牛
櫆	木 鬼 斗
欂	木 落字框 甫 寸
欸	厶 矢 欠
欻	火 火 欠
歅	覀 土 欠
殣	歹 革 二
毌	毌
毐	士 毋
毪	毛 厶 牛
氇	毛 鱼 日
氕	气 丿
氾	氵 㔾
氿	氵 九
汈	氵 乛 一
汋	氵 勹 丶
汧	氵 开
汫	氵 井
汭	氵 内
沄	氵 云
沇	氵 厶 儿
沘	氵 比
沚	氵 止
沨	氵 风
沺	氵 田
泂	氵 冂 口
泃	氵 句
泇	氵 力 口
泙	氵 平
泚	氵 此
泜	氵 氏 丶
洈	氵 尔字头 厂 㔾
洑	氵 亻 犬
洓	氵 木框 冂
洘	氵 耂 丂
洢	氵 亻 尹
洣	氵 米
洨	氵 交
洭	氵 匚 王
洴	氵 丷 开
洸	氵 光
洺	氵 夕 口
洿	氵 大 亏
浉	氵 师字旁 一 巾
浐	氵 产
浕	氵 尺 冬字底
浛	氵 今 口
浟	氵 修字旁 攵
浡	氵 索字头 子
浥	氵 邑
浬	氵 里
浭	氵 更
浰	氵 禾 刂
浲	氵 夂 丰
涄	氵 由 丂
涍	氵 耂 子
涐	氵 我
涘	氵 厶 矢
涢	氵 员
涴	氵 宀 夕 㔾
淏	温字框 天
淜	氵 月 月
淟	氵 典字头 一 八
淯	氵 充字头 青字底
淴	氵 勹 横两撇 心
渟	氵 亮字头 丁
渰	氵 合 廾
渼	氵 美字头 大
湉	氵 忄 舌
湑	氵 疋 青字底
湜	氵 是
湝	氵 比 白
湣	氵 民 日
湲	氵 爫 一 友
湴	氵 䒑 业
溁	氵 荧字头 木
溇	氵 娄
溍	氵 亚 日
溚	氵 艹 合
溞	氵 又 丶 虫
溠	氵 差字头 工
溦	氵 山一 几 攵
溵	氵 㐆 殳
溹	氵 索字头 糸
滃	氵 公 羽
滆	氵 鬲
滉	温字框 光
滍	氵 屮 一 虫
滘	氵 㓁 工 口
滧	氵 交 攵
滪	氵 予 页
滫	氵 修字旁 夂 青字底
漈	氵 祭字头 示
漋	氵 阝 夂 一 生
漖	氵 耂 子 攵
漤	氵 林 女
漦	未 攵 厂 水
漴	氵 山 宀 示
漷	氵 享字头 子 阝
漹	氵 正 与无横 灬
漻	氵 羽 全字头 彡
漼	氵 山 隹
潏	氵 矛 𠕉字底 口
潖	氵 王 王 巴
潟	氵 臼 勹 灬
潩	氵 田 共
潵	氵 龷 青字底 攵
潽	氵 䒑 业 日
潾	氵 米 舛
澂	氵 山一 王 攵
澛	氵 鱼 日
澥	氵 角 刀 牛
澪	氵 雨头 今 丶
澭	氵 亠 乡 隹
澴	氵 罒 同字心 衣省
澼	氵 辟
澽	氵 虍 豕
濋	氵 林 疋
濩	氵 艹 隹 又
瀌	氵 鹿 灬
瀍	氵 广 里 八 土
瀔	氵 壳字头 一 禾 殳
瀱	氵 罒 厂 火 火 刂
瀼	氵 衣框 吅 寒字腰
灈	氵 目 目 隹
炆	火 文
炌	火 介
炟	火 旦
炣	火 可
烔	火 冂 同字心
烜	火 一 旦
烝	氶 一 灬
烠	火 左字框 青字底
烶	火 壬 廴
烺	火 丶 艮
烻	火 延字心 廴
焆	火 口 青字底
焌	火 厶 八 夂
焗	火 尸 乛 口
焘	寿字头 寸 灬
焜	火 日 比
焞	火 享字头 子
煁	火 其 乛
煃	火 大 圭
煋	火 日 生
煓	火 山 而
煟	火 田 青字底
煴	火 日 皿
熇	火 高
熛	火 覀 示
熜	火 囱 心
熥	火 龴 甬字底 辶
熻	火 合 羽
燊	火 火 火 木
燋	火 隹 灬
燏	火 矛 𠕉字底 口
燚	火 火 火 火
爇	艹 土 八 土 丸 灬
爔	火 美字头 禾 丂 戈无一
爚	火 龠
爟	火 艹 吅 隹
牁	爿 可
牂	爿 羊
牚	尚头 牙
牤	牜 亡
牥	牜 方
牮	亻 弋 牛
牻	牜 龙 纵两撇
犇	牛 牜 牛
犨	隹 隹 牛
狉	犭 不 一
狝	犭 尔字头 小
狨	犭 戈 左字框
猄	犭 京
猇	犭 虎
猯	犭 山 而
猰	犭 丰 刀 大
猺	犭 爫 缶
獴	犭 荧字头 一 豕
玃	犭 目 目 隹 又
玒	王 工
玓	王 勹 丶
玕	王 干
玘	王 己
玙	王 与
玚	王 乛 横两撇
玞	王 夫
玠	王 介
玡	王 牙
玤	王 丰
玥	王 月
玦	王 夬
玭	王 比
玱	王 全字头 㔾
玶	王 平
玹	王 亠 幺
玼	王 此
玿	王 刀 口
珅	王 日 丨
珇	王 且
珋	王 卯
珌	王 心 丿
珒	王 聿
珕	王 力 力 力
珖	王 光
珛	王 左字框 青字底
珝	王 羽
珢	王 艮
珣	王 勹 日
珦	王 向字框 口
珪	王 圭
珫	王 充字头 儿
珰	王 尚字头 彐
珵	王 口 王
珷	王 一 弋 止
珸	王 五 口
珹	王 成三 戈无一
珺	王 君
珽	王 壬 廴
琀	王 今 口
琄	王 口 青字底
琇	王 禾 乃
琈	王 爫 子
琎	王 井 辶
琔	王 定
琟	王 隹
琡	王 上 小 又
琤	王 尔字头 争字底
琫	王 春字头 举字底
琭	王 录字头 氺
琯	王 宀 㠯
琲	王 非
瑀	王 丿 口 禺字底
瑂	王 眉字框 目
瑃	王 春字头 日
瑄	王 宀 一 旦
瑅	王 是
瑆	王 日 生
瑑	王 彑 豕省
瑓	王 束 丷
瑔	王 白 水
瑖	王 段字旁 殳
瑝	王 白 王
瑢	王 宀 谷
瑧	王 春字头 禾
瑨	王 亚 日
瑬	氵 㐬 玉
瑱	王 直 八
瑳	王 差字头 工
璆	王 羽 全字头 彡
璈	王 敖字旁 攵
璒	王 癶 豆
璘	王 米 舛
璟	王 景
璠	王 釆 田
璥	王 艹 句 攵
璪	王 口 吅 木
璬	王 白 方 攵
璮	王 亠 囗 口 旦
璱	王 王 王 心 丿
璲	王 丷 豕 辶
瓀	王 雨头 而
瓖	王 衣框 吅 寒字腰
瓘	王 艹 吅 隹
瓻	乂 左字框 巾 瓦
甗	虍 鬲 瓦
甡	生 生
甦	更 生
甪	丿 用
畖	田 瓜
畤	田 土 寸
畬	全字头 余字底 田
畯	田 厶 八 夂
疁	田 羽 全字头 彡
疍	疋 旦
疐	索字头 田 疋
疢	疒 火
疭	疒 从
痃	疒 亠 幺
痄	疒 乍
痓	疒 至
瘆	疒 厶 大 彡
瘭	疒 覀 示
癗	疒 雨头 田
癿	白 乛
皕	百 百
皛	白 白 白
皞	白 白 大 十
皦	白 白 方 攵
皭	白 爫 罒 即字旁 寸
盉	禾 皿
盦	今 酉 皿
盷	目 勹 冫
眊	目 毛
睄	目 尚字头 青字底
睎	目 乂 左字框 巾
瞫	目 覀 早
矞	矛 𠕉字底 口
矰	矢 丷 曾字头无丷 日
矻	石 卧人 乙
矼	石 工
砄	石 夬
砆	石 夫
砠	石 且
砫	石 主
砮	女 又 石
砵	石 本
硁	石 经右角 工
硊	石 尔字头 厂 㔾
硍	石 艮
硔	石 共
硙	石 山 己
硚	石 夭 乔字底
硿	石 穴 工
碃	石 龶 青字底
碈	石 氏 日
碏	石 龷 日
碥	石 户 扁字心
碨	石 田 一 畏字底
碶	石 丰 刀 大
磏	石 䒑 聿三 兼无䒑无彐
磜	石 祭字头 示
磡	石 其 乛 力
磹	石 覀 早
磻	石 釆 田
礌	石 雨头 田
礞	石 荧字头 一 豕
礵	石 雨头 相
祃	礻 马
祊	礻 方
祋	礻 殳
祎	礻 韦
祏	礻 石
祲	礻 彐 冖 又
祼	礻 果
祾	礻 土 八 夂
禋	礻 覀 土
禒	礻 彑 豕省
禔	礻 是
禘	礻 立无横 冖 巾
禚	礻 美字头 灬
禛	礻 直 八
禤	礻 罒 羽
秬	禾 匸 叚右角
秾	禾 冖 衣省
稃	禾 爫 子
稌	禾 全字头 余字底
稑	禾 土 八 土
稙	禾 直
穄	禾 祭字头 示
穙	禾 业 养字头
穜	禾 童
穟	禾 丷 豕 辶
窅	穴 目
窊	穴 瓜
窎	穴 鸟
竘	立 句
竫	立 尔字头 争字底
笯	竹头 女 又
筀	竹头 圭
筜	竹头 尚字头 彐
筤	竹头 丶 艮
筥	竹头 吕
筦	竹头 宀 元
筶	竹头 告字头 口
筼	竹头 员
箖	竹头 林
簃	竹头 禾 夕 夕
簉	竹头 告字头 口 辶
簕	竹头 革 力
簖	竹头 米 乛 斤
簝	竹头 大 丷 日 小
簠	竹头 甫 皿
簰	竹头 片 卑
籥	竹头 龠
粿	米 果
糒	米 龷 丿 甬字底
糵	艹 追字心 辛 米
絜	丰 刀 糸
縠	壳字头 一 糸 殳
縢	月 龹 糸
繄	匚 矢 殳 糸
纮	纟 左字框 厶
纴	纟 壬
纻	纟 宀 一
纼	纟 弓 丨
绖	纟 至
绤	纟 谷
绹	纟 勹 缶
缊	纟 日 皿
缐	纟 白 水
缞	纟 衣框 口 一
罍	田 田 田 缶
罶	罒 留字头 田
罽	罒 厂 火 火 刂
羑	美字头 久二 丶
羓	差字头 巴
羕	美字头 丶 永无点
羖	差字头 殳
羱	差字头 原
翂	羽 分
翃	左字框 厶 羽
翈	甲 羽
翙	山 夕 羽
翚	羽 冖 车
翛	修字旁 夂 羽
翯	羽 高
翷	米 舛 羽
翾	罒 同字心 衣省 羽
耇	耂 句
耏	而 彡
耑	山 而
耖	耒 少
耢	耒 荧字头 力
耤	耒 龷 日
耥	耒 尚
耰	耒 丆 且无横 冖 心 夂
肸	月 八 十
胈	月 友 丶
胠	月 去
胣	月 卧人 也
脎	月 乂 朩
脟	月 爫 寸
脩	修字旁 夂 青字底
脶	月 呙
脿	月 龶 衣省
腒	月 居
腘	月 囗 玉
腙	月 宀 示
腨	月 山 而
腯	月 反字框 十 目
膙	月 弓 口 虫
臑	月 雨头 而
臜	月 先 先 贝
舠	舟 刀
舥	舟 巴
舲	舟 今 丶
艅	舟 全字头 余字底
艎	舟 白 王
芃	艹 凡
芠	艹 文
芣	艹 不
芼	艹 毛
苉	艹 匸 儿
苠	艹 民
苧	艹 宀 丁
苾	艹 心 丿
茀	艹 弗
茋	艹 氏 丶
茓	艹 穴
茝	艹 颐字旁
茽	艹 亻 中
荁	艹 一 旦
荄	艹 亥
荓	艹 丷 开
荖	艹 老
荙	艹 大 辶
荮	艹 纟 寸
莙	艹 君
莝	艹 从 土
莰	艹 土 欠
莶	艹 亼 应字心
莿	艹 木框 冂 刂
菂	艹 白 勹 丶
菉	艹 录字头 氺
菍	艹 今 心
菥	艹 木 斤
菼	艹 火 火
萚	艹 扌 又 举字底
萣	艹 定
萩	艹 禾 火
萳	艹 十 冂 南字心
萹	艹 户 扁字心
葖	艹 穴 犬
葙	艹 相
葰	艹 亻 厶 八 夂
葴	艹 戊 同字心
蒄	艹 冖 元 寸
蒈	艹 比 白
蒎	落字框 反字框 旅下角
蒐	艹 鬼
蒗	落字框 丶 艮
蒟	艹 立 句
蒨	艹 亻 龶 青字底
蒱	艹 扌 甫
蒻	艹 弓 冫 弓 冫
蓂	艹 冖 日 六
蓇	艹 骨
蓏	艹 瓜 瓜
蓢	艹 丶 即字旁 月
蓣	艹 予 页
蔀	艹 咅 阝
蔃	艹 弓 口 虫
蔈	艹 覀 示
蔊	艹 火 日 干
蔹	艹 亼 应字心 攵
蕗	艹 足旁 各
蕰	艹 温字框 皿
蕲	艹 丷 旦 丨 斤
薁	艹 向字框 米 大
薢	艹 角 刀 牛
薳	艹 土 口 衣省变 辶
薸	艹 氵 覀 示
薿	艹 匕 矢 龴 疋
藟	艹 田 田 田
藠	艹 白 白 白
藦	艹 麻 手
藨	艹 鹿 灬
蘘	艹 衣框 吅 寒字腰
虒	反字框 虎
虓	九 虎
虤	虎 虎
虷	虫 干
虸	虫 子
蚄	虫 方
蚆	虫 巴
蚲	虫 平
蛃	虫 一 内
蜎	虫 口 青字底
蜐	虫 去 力
蝘	虫 匚 日 女
蝲	虫 束 刂
螗	虫 唐
螠	虫 益字头 皿
螣	月 龹 虫
螱	尸 示 寸 虫
蟏	虫 艹 肀 乔字底 八
蟫	虫 覀 早
蠋	虫 罒 勹 虫
衃	血 不
衎	行 干
衒	行 亠 幺
衠	行 直 八
袆	衤 韦
袗	衤 全字头 彡
袪	衤 去
袯	衤 发
裈	衤 冖 车
裛	衣框 邑
褕	衤 亼 青字底 刂
褟	衤 日 羽
褯	衤 度字框 巾
襕	衤 门 束 丷
襚	衤 丷 豕 辶
襜	衤 尔字头 厂 八 言
襫	衤 大框 百 百
觃	见 子
觟	角 圭
觭	角 大 可
觱	戊 同字心 角
觿	角 山 隹 𠕉字底 口
訄	九 言
訚	门 言
詟	龙 言
讱	讠 刀 丶
讻	讠 凶
诇	讠 冂 口
诐	讠 皮
谞	讠 疋 青字底
谼	谷 共
谿	爫 幺 大 谷
豨	豕 乂 左字框 巾
豮	豕 十 艹 贝
貆	豸 一 旦
赑	贝 贝 贝
赒	贝 周字框 土 口
赗	贝 冒字头 目
赟	文 一 弋 止 贝
赪	土 亦字底 卢字头 贝
趯	走 羽 隹
跂	足旁 支
跐	足旁 此
跱	足旁 土 寸
踒	足旁 禾 女
踦	足旁 大 可
踶	足旁 是
蹅	足旁 木 旦
蹐	足旁 率字腰 人 青字底
蹜	足旁 宀 亻 百
蹢	足旁 立无横 冂 古
蹽	足旁 大 丷 日 小
蹾	足旁 享字头 子 攵
轪	车旁 大
轷	车旁 乊 于无横
辀	车旁 舟
辌	车旁 京
辒	车旁 日 皿
辿	山 辶
迺	西 辶
逴	卢字头 早 辶
遆	立无横 冖 巾 辶
遹	矛 𠕉字底 口 辶
邘	一 于无横 阝
邠	分 阝
邲	心 丿 阝
邽	圭 阝
邿	土 寸 阝
郈	后字框 口 阝
郚	五 口 阝
郤	谷 阝
郪	妻字头 女 阝
郿	眉字框 目 阝
鄀	艹 左字框 口 阝
鄃	亼 青字底 刂 阝
鄅	丿 口 禺字底 阝
鄌	唐 阝
鄑	亚 日 阝
鄗	高 阝
鄘	广 肀 甬字底 阝
鄚	莫 阝
鄜	鹿旁 阝
鄠	雨头 亏 阝
鄫	丷 曾字头无丷 日 阝
酂	先 先 贝 阝
酅	山 隹 𠕉字底 口 阝
酏	酉 也
酦	酉 发
酺	酉 甫
醌	酉 日 比
醨	酉 㐫 禸
醾	酉 麻 米
釐	未 攵 厂 里
钆	钅 乛
钖	钅 乛 横两撇
钘	钅 开
钷	钅 匚 口
铏	钅 开 刂
铕	钅 左字框 青字底
铚	钅 至
铥	钅 𡈼 厶
铷	钅 女 口
铹	钅 荧字头 力
铻	钅 五 口
铽	钅 弋 心
锧	钅 反字框 十 贝
锳	钅 艹 见二 大
锽	钅 白 王
镃	钅 䒑 幺 幺
镈	钅 甫 寸
镋	钅 尚头 儿
镚	钅 山 月 月
镠	钅 羽 全字头 彡
镤	钅 业 养字头
镮	钅 罒 同字心 衣省
镴	钅 巛 巤字底
镵	钅 免五 比 兔
阇	门 者
阘	门 日 羽
陎	阝 丿 未
陑	阝 而
陞	阝 丿 廾 土
隃	阝 亼 青字底 刂
隩	阝 向字框 米 大
隺	冖 隹
雊	句 隹
霅	雨头 言
霨	雨头 尸 示 寸
靬	革 干
靰	革 丆 乛
靸	革 及
靺	革 末
靽	革 半
靿	革 幺 力
鞁	革 皮
鞡	革 扌 立
鞧	革 酋
鞨	革 曷
鞬	革 聿 廴
鞮	革 是
鞳	革 艹 合
韂	革 尔字头 厂 八 言
韨	韦 友 丶
颋	壬 廴 页
颙	日 禺字底 页
飏	风 乛 横两撇
飐	风 占
飔	风 田 心
飗	风 留字头 田
饳	饣 屮 凵
饸	饣 合
饹	饣 各
饻	饣 衣
馉	饣 骨
馌	饣 去 皿
馝	禾 日 心 丿
馞	禾 日 索字头 子
馧	禾 日 日 皿
驲	马 日
骃	马 囗 大
骉	马 马 马
骎	马 彐 冖 又
骕	马 肀 乔字底 八
骙	马 癶 天
骦	马 雨头 相
骺	骨 后字框 口
髃	骨 日 禺字底
髎	骨 羽 全字头 彡
髢	镸 彡 也
髽	镸 彡 从 土
鬒	镸 彡 直 八
鬘	镸 彡 日 罒 又
鬶	夫 见 鬲
鬷	鬲 凶 八 夂
魆	鬼 戉
魋	鬼 隹
鱽	鱼 刀
鱾	鱼 己
鲉	鱼 由
鲊	鱼 乍
鲌	鱼 白
鲏	鱼 皮
鲖	鱼 冂 同字心
鲗	鱼 贝 刂
鲘	鱼 后字框 口
鲙	鱼 全字头 云
鲝	差字头 鱼
鲪	鱼 君
鲬	鱼 龴 甬字底
鲯	鱼 其
鲴	鱼 囗 古
鲹	鱼 厶 大 彡
鲺	鱼 乛 丿 虫
鲾	鱼 同字心 田
鲿	鱼 龸 云
鳀	鱼 是
鳁	鱼 日 皿
鳂	鱼 田 一 畏字底
鳈	鱼 白 水
鳉	鱼 丬 夕 寸
鳑	鱼 立无横 冖 方
鳒	鱼 䒑 聿三 兼无䒑无彐
鳓	鱼 革 力
鳛	鱼 羽 白
鳠	鱼 艹 隹 又
鳡	鱼 戊 同字心 心
鳣	鱼 亠 囗 口 旦
鳤	鱼 竹头 宀 㠯
鸤	尸 鸟
鸧	全字头 㔾 鸟
鸮	口 丂 鸟
鸰	今 丶 鸟
鸻	行 鸟
鸼	舟 鸟
鹀	工 从 鸟
鹍	日 比旁 鸟
鹐	负字头 臼 鸟
鹒	广 聿三 人 鸟
鹔	肀 乔字底 八 鸟
鹖	曷 鸟
鹙	禾 火 鸟
鹝	鬲 鸟
鹟	公 羽 鸟
鹠	留字头 田 鸟
鹡	率字腰 人 青字底 鸟
鹢	益字头 皿 鸟
鹯	亠 囗 口 旦 鸟
鹲	荧字头 一 豕 鸟
鹴	雨头 相 鸟
麀	鹿 匕
麑	鹿 臼 儿
麖	鹿 京
麹	麦 勹 米
黇	黄 占
黡	厂 犬 黑
鼒	才 目 鼎字框
鼩	鼠 句
鼫	鼠 石
鼽	鼻 九
齁	鼻 句
齇	鼻 虍 且
齉	鼻 囊字头 吅 寒字腰 衣省
龁	齿 卧人 乙
龂	齿 斤
鿍	土 夂 㐄
鿎	石 大 辶
鿏	钅 麦
𠅤	亠 田 心
𠙶	了 凵
𠳐	口 寿字头 阝
𡎚	土 户 扁字心
𡐓	土 广 隶字框 率字腰
𣗋	木 尚头 儿
𣲗	氵 韦
𣲘	氵 无
𣸣	氵 十 艹 贝
𤧛	王 立无横 冖 巾
𤩽	王 十 冂 南字心 犬
𤫉	王 言 火 火 又
𥔲	石 吅 亏
𥕢	石 一 曲 日
𥖨	石 口 吅 木
𥻗	米 木 旦
𦈡	纟 雨头 而
𦒍	童 羽
𦙶	月 古
𦝼	月 娄
𦭜	艹 只
𦰡	艹 那字旁 阝
𧿹	足旁 母
𨐈	车旁 光
𨙸	支 阝
𨚕	厶 廾 阝
𨟠	目 目 隹 阝
𨭉	文 一 弋 止 金
𨱇	钅 求
𨱏	钅 艹 合
𨱑	钅 黄
𨱔	钅 酋 寸
𨺙	阝 臼 儿
𩽾	鱼 宀 女
𩾃	鱼 免五 儿
𩾌	鱼 广 隶字框 率字腰
𪟝	龶 贝 力
𪣻	土 娄
𪤗	土 羽 全字头 彡
𪨰	山 曲
𪨶	山 大 车
𪩘	山 十 冂 南字心 犬
𪾢	目 见
𫄧	纟 延字心 廴
𫄷	纟 音 心
𫄸	纟 千 黑
𫇭	艹 丶 力 丶
𫌀	衤 龶 贝
𫍣	讠 冂 同字心
𫍯	讠 戊 同字心
𫍲	讠 臼 丨 又
𫍽	讠 罒 同字心 衣省
𫐄	车旁 丆 乛
𫐐	车旁 臼 儿
𫐓	车旁 矛 木
𫑡	黾 阝
𫓧	钅 夫
𫓯	钅 圭
𫓶	钅 口 青字底
𫓹	钅 其
𫔍	钅 釆 田
𫔎	钅 矛 𠕉字底 口
𫔶	门 自 木
𫖮	山 己 页
𫖯	儿 率字腰 页
𫖳	君 页
𫗧	饣 束
𫗴	饣 亠 囗 口 旦
𫘜	马 文
𫘝	马 夬
𫘦	马 勹 缶
𫘧	马 录字头 氺
𫘨	马 是
𫘪	马 原
𫘬	马 爫 幺 大
𫚕	鱼 师字旁 一 巾
𫚖	此 鱼
𫚭	鱼 巛 巤字底
𫛭	犭 王 鸟
𫞩	王 艹 两
𫟅	纟 京
𫟦	车旁 丷 豕 辶
𫟹	钅 共
𫟼	钅 大 辶
𫠊	马 亠 幺
𫠜	齿 臼 儿
𫢸	亻 丷 旦 丨
𫫇	口 亚 心
𫭟	土 区
𫭢	土 仑
𫭼	土 荧字头 力
𫮃	土 丷 旦 丨
𫰛	女 经右角 工
𫵷	山 厂 力
𫶇	山 带字头 冖 巾
𫷷	广 钅 欠
𫸩	弓 区
𬀩	日 韦
𬀪	日 见
𬂩	木 夹
𬃊	木 反字框 十 贝
𬇕	氵 万
𬇙	氵 贝
𬇹	氵 囗 玉
𬉼	火 区
𬊈	火 彐 寸
𬊤	火 丷 旦 丨
𬌗	牙 合
𬍛	王 乐二 小
𬍡	氵 乛 横两撇 玉
𬍤	王 彐 寸
𬒈	学无子 石
𬒔	石 止 青字底
𬒗	石 览字头 见
𬕂	竹头 工 贝
𬘓	纟 川
𬘘	纟 冖 儿
𬘡	纟 囗 大
𬘩	纟 壬 廴
𬘫	纟 宀 元
𬘬	纟 龶 青字底
𬘭	纟 林
𬘯	纟 享字头 子
𬙂	纟 宀 一 由 八
𬙊	纟 黑 土
𬙋	纟 衣框 吅 寒字腰
𬜬	艹 门 口
𬜯	艹 两
𬞟	艹 止 步字底 页
𬟁	艹 鬲 鸟
𬟽	虫 东二 小
𬣙	讠 一 于无横
𬣞	讠 宀 一
𬣡	讠 戋
𬣳	讠 艮
𬤇	讠 覀 土
𬤊	讠 是
𬤝	讠 凬字心 虫无口 心
𬨂	车旁 氏
𬨎	车旁 酋
𬩽	彐 寸 阝
𬪩	酉 冖 衣省
𬬩	钅 弋
𬬭	钅 仑
𬬮	钅 长
𬬱	钅 斤
𬬸	钅 木 丶
𬬹	钅 日 丨
𬬻	钅 卢字头 尸
𬬿	钅 刀 口
𬭁	钅 母
𬭊	钅 木 土
𬭎	钅 宀 左字框 厶
𬭚	钅 享字头 子
𬭛	钅 氵 皮
𬭤	钅 亻 候右角 矢
𬭩	钅 公 羽
𬭬	钅 丰 丰 彐
𬭯	钅 㡀 攵
𬭳	钅 壴 口
𬭶	钅 黑
𬭸	钅 米 舛
𬭼	钅 丷 豕 辶
𬮱	门 覀 土
𬮿	阝 山 己
𬯀	阝 齐
𬯎	阝 贵字头 贝
𬱖	由 页
𬱟	尔字头 厂 㔾 页
𬳵	马 不 一
𬳶	马 冂 口
𬳽	马 先
𬳿	马 全字头 余字底
𬴂	马 非
𬴃	马 丰 石
𬴊	马 米 舛
𬶋	鱼 句
𬶍	鱼 宀 匕
𬶏	鱼 尔字头 厂 㔾
𬶐	鱼 儿 率字腰
𬶟	鱼 束 刂
𬶠	鱼 束 丷
𬶨	即字旁 旡 鱼
𬶭	鱼 祭字头 示
𬶮	鱼 壴 口
𬷕	甫 鸟
𬸘	匚 日 女 鸟
𬸚	犭 讠 犬 鸟
𬸣	寒字头 鸟
𬸦	旅字框 矢 鸟
𬸪	釆 田 鸟
𬹼	齿 介
𬺈	齿 大 可
𬺓	齿 林 疋
舁	臼 廾
鲕	鱼 而
嬥	女 羽 隹
鼱	鼠 龶 青字底
𫄨	纟 乂 左字框 巾
𫠆	支 页