zpo	丶
xpo	口   〇 
yfu	勹  
l;w	亻 
zsu	白
bdo	寸
ksw	辶
,dw	   
/sr	又  龴  
.ar	一
npw	土 
nar	扌  𰀁   𘠲 󱣣 󲟎 𘠩
ssu	木 朩   㝳 𣎳
cvu	匕   
h;w	日 
mcw	心
fdo	十  
k;w	讠
mmo	刂      ⺉ 𘮖
gsu	女 
m;w	氵
;aw	大 
vjo	是
.,w	力 
czo	禾  
hfo	人
,ao	宀
anr	子
apu	厶 
z;o	阝
/ko	
jao	不
gkw	工
dju	 彡 ⺀    𘡂 𘬀 󲻝 𰀪
qgo	王   ⺩
d;o	纟 
f;w	可
;;r	丿
t,u	火 灬   
vco	攵 攴
vkw	巾 
s;r	你
t.w	也
vvu	  𠮛
dlw	丨
/zr	贝
b,w	牛 牜 
jaw	旦
tno	月  円
pvr	冂 冖     
fmw	云  𠫓  󰂫 
bvu	丰 龶  丯
y;u	艹 廾 丱 ⻀ 卄 ⺿  󰓯 𫡃 
d,r	门
far	戈 戈无一 
bzo	兴    𰃮 󰅄 
cpu	㐅 𘱌 乂 乄 𘠘
,vo	冫    
adu	文
gho	了 𠄏
d/u	
;vo	囗
cmu	丷
;so	我
tqo	小     𡭔
cyu	兄
zzu	 
/ko	竹  
llw	斤 
kau	西 覀 襾
qvu	田
jfr	夂 夊
str	页
yaw	犬 犭
ppw	忄  ⺗  󰍒 㣺 󳖶
ztu	欠
yxo	中 𘯉
c;o	目
xfu	彳
lqu	卩 㔾   卪 𭅲
ptw	艮 
bho	广 
.hr	刀 
/aw	开 
c.u	车 
;hu	乛
xco	至
jyr	羊     ⺶
gyo	儿
vpu	耳
hlw	见
glu	生
ypo	聿    ⺺   肀 ⺻ 󰧳 󰈡 󱌱
dhr	八 
q;r	而
jso	上
sfo	殳
nar	几  
kqo	吕 吅 
jzw	里
ngo	者
,cw	矢
jto	用 
mqr	方
zko	己 
syo	且 
pso	其
djw	去
kaw	合
gmr	厂 
hkw	手 龵   
zvu	尢 兀 丌  󰘆
dzw	角
g;w	此
jbo	多
,aw	立 
v;w	自
qbo	衣     
spo	夕
/qw	彐   𬺹
jzo	二
b;w	来
xdr	礻 衤
shu	舌 
x;u	隹
.bo	正
vgo	石
hqr	糸 幺 ⺯
bjw	马 
fkr	片 丬   爿    
alr	廴
dxo	各
hxo	本
hgo	京
hdr	果
fqu	更
aao	钅
daw	乍
;ku	米  𠂭 󱹐 󳦲
ajr	相
qqr	䒑  󰦙
jlr	弋 
;/o	占
mtr	止  龰 
lpu	雨 
jpw	弓 𢎜
;vw	直
vno	尸       
jmu	虫  󲴢 𘯊 𠀐
fku	卜 
slr	主
flw	下 󰷣
/zw	示 ⺬ 𱍐
tau	关
hzr	士
ygu	尚  龸
,/r	万 成三
g;u	壬 𡈼
.lr	豕 乑  豸 𬺻  𧰧 𬺷
cqu	言
v.w	行
jpr	水 氺     
qfu	元
bsw	音 󲨣
fsw	   
qpr	出
aco	巴
smr	业
pxu	高    󰂗 󰂘
cno	玉
kqr	古
t/w	祭   癶 
s,w	分
kvr	交
.gw	走
tpu	先
mpr	亼 亽
fnr	内
nkr	戉 戊 
pao	户
yvw	
b.w	只
spr	 耂
gpr	足 
/ao	疒
zcr	
bzu	母
sdu	四 罒 
tyr	共
zxr	丂  
v,w	定
qto	夫
jlr	发
hao	天
nto	㐄    𫝀 󰆃 𘲐
zbw	井 
kju	甬
qyw	皿
yqr	⺃
,jr	㠯  𮍌 
fjw	比 
hqo	皮 
s;w	亠
vjw	戶 戸 
acu	凵 丩  𠙴 𠂈
qlw	化
bcu	及
bpw	非
pfu	之
dku	夬
knr	匚   匸   𠥓
cxo	娄
jkr	面
;qr	亥
hqu	廿 龷  
vlr	今
/vu	  
.vu	歹 歺 
lar	专
,mw	从  仌
vau	首
qgw	丁 
alo	七    
.tr	包
ado	穴
yco	求
nsr	由
a,u	介
bdu	山 
vdo	长
dyw	爪 爫 乊  ⺥ 𫜵 𱬴
x;u	电   󰂊
zpr	咅
b/w	亲
afu	身 㐆
qlr	两
;go	与
zju	才
fjo	公
tqr	册  冊 𠕁 󱼬
kco	居
qnr	无
;tr	
zlr	产
gnw	支
hqw	 󰘀
byr	句
hso	友
dvo	平
pzu	原
x;u	     󰀣 󱀺
x;r	少
pvw	川   巛 巜 𘠸    
lkw	戋
zzo	巳
l;r	斗
knr	早
lqw	五
smu	另
vcw	谷 
apr	酉
,,r	予
yxo	爻 
q;u	束
dyr	景
gpw	㓁 󰈯  󰛟 󰏖
clo	妾
gnr	未
vpu	禸 
dlr	太
.zo	 󱅫
t;o	氏
,,w	亡
z;r	入
.ho	莫
/gu	金  釒 
aau	亦 
z/r	三
nnw	员
,lu	舟
..w	区
mqw	仑
c,w	气
.hw	凶 㐫
ypr	乃 
a;w	象
,bu	申
zco	北 
vqu	 
adw	肖
dpw	老
.du	虎 虍 
//w	九
zmw	已
;xr	臼   ⺽  
t;r	 疋  
qdu	执
lcr	㐬
fpo	食 飠 ⻞  ⻟ 𩙿
ysw	干  𘠨
/qr	龹  󰄾 󰃳 󲼶
.tw	习
csr	饣
dfr	
/qu	弗  𠂔
bxr	 
ksr	缶 
dyr	
kfu	民
fyr	林
npo	壴
yto	风
mzo	圭
,mr	羽
ppr	双
vhu	甘  
d,o	冉
.fu	       𰀂 𰀄
l;w	豆
g,r	亚
qqu	旡
;.r	毛
lnr	牙
.su	 
dfu	釆
..w	温字框
kfw	甫 
aqw	卯   󰘇 󱨧
s;o	尺
;jr	百
zgu	光
v.r	卅  丗 𠀍
gaw	韦
;du	刍
nvr	 󰔔
hcu	革
c;r	麻
cvu	辛 
lmr	黑 黒
cfw	
lfo	齐 斉
m,u	卑
tvw	鸟 
kbu	曲 
.qo	辟
gco	半
kar	奂
qqw	
/kr	千 
qsu	鱼
;gu	巨
qgr	夭
t;u	 𡗗  󲕅 𘬑
far	
plr	君
tmw	父
kqr	彑 
yxr	凡
zjo	敫
cso	鬼 
kju	酋
fbu	龙
kcw	肉
xyu	龺
xbo	亏
fqw	血
tfr	臣 
gju	曷
pqr	鬲
n.w	垂
;mr	氶
nlw	叚
ypw	屯  
,vr	骨 咼 冎 
qyr	瓦
nfr	⻑ 镸 長
jhw	兵
;fr	丸 
cbu	辰
zvw	甲
t,w	六
,sr	卤 囱 囟
/vu	飞 
gnu	唐
psu	毋 毌  𣫬
mpr	舛
j;u	耒
m.r	末
mgr	瓜
aho	矛
jgo	呙
,ao	乌
dfw	曰  
fmr	齿
,,o	夹
tdr	童
fxu	草
hdu	丅 丆
vqw	魚  
fqu	車  󲣴
/,r	屮 䶹 
hpr	鼻
lsr	貝
vqw	  󰾂
vdr	芒
,hr	尹
vqu	麦
gpu	乡
yqr	敖
sju	鼠  
fpr	㡀
bko	門 鬥
fqu	
kgr	兔 
cvw	丹
t/o	頁 󰯷
;fo	鹿  
yfu	卵
jpo	黾
yyu	  𦣝  
a,w	見
.mr	馬 
mxu	韋
fzr	 
fao	僉 㑒
lnu	侖
vlu	邑
dau	龻 䜌
/sw	鳥 
bpo	風
mqo	亞 𬻞
.zw	
/go	㦮 
zyw	卌 
fbr	
zsr	烏 
zjr	   
.jo	麥
kxu	 
.dw	亾 兦
;to	丄
kpu	⺼ 
aqo	特殊折
